DistrictId,District,Population,Week,Year,NewConfCases,NewDeaths,TotalConfCases,TotalDeaths
101,Bezirk Affoltern,55111,9,2020,0,0,0,0
101,Bezirk Affoltern,55111,10,2020,1,0,1,0
101,Bezirk Affoltern,55111,11,2020,6,0,7,0
101,Bezirk Affoltern,55111,12,2020,23,1,30,1
101,Bezirk Affoltern,55111,13,2020,34,0,64,1
101,Bezirk Affoltern,55111,14,2020,19,2,83,3
101,Bezirk Affoltern,55111,15,2020,10,1,93,4
101,Bezirk Affoltern,55111,16,2020,2,0,95,4
101,Bezirk Affoltern,55111,17,2020,3,0,98,4
101,Bezirk Affoltern,55111,18,2020,2,0,100,4
101,Bezirk Affoltern,55111,19,2020,1,0,101,4
101,Bezirk Affoltern,55111,20,2020,1,0,102,4
101,Bezirk Affoltern,55111,21,2020,0,0,102,4
101,Bezirk Affoltern,55111,22,2020,0,0,102,4
101,Bezirk Affoltern,55111,23,2020,0,0,102,4
101,Bezirk Affoltern,55111,24,2020,0,0,102,4
101,Bezirk Affoltern,55111,25,2020,1,0,103,4
101,Bezirk Affoltern,55111,26,2020,1,0,104,4
101,Bezirk Affoltern,55111,27,2020,3,0,107,4
101,Bezirk Affoltern,55111,28,2020,4,0,111,4
101,Bezirk Affoltern,55111,29,2020,4,0,115,4
101,Bezirk Affoltern,55111,30,2020,4,0,119,4
101,Bezirk Affoltern,55111,31,2020,6,0,125,4
101,Bezirk Affoltern,55111,32,2020,8,0,133,4
101,Bezirk Affoltern,55111,33,2020,3,0,136,4
101,Bezirk Affoltern,55111,34,2020,13,0,149,4
101,Bezirk Affoltern,55111,35,2020,12,0,161,4
101,Bezirk Affoltern,55111,36,2020,9,0,170,4
101,Bezirk Affoltern,55111,37,2020,14,0,184,4
101,Bezirk Affoltern,55111,38,2020,11,0,195,4
101,Bezirk Affoltern,55111,39,2020,10,0,205,4
101,Bezirk Affoltern,55111,40,2020,24,0,229,4
101,Bezirk Affoltern,55111,41,2020,19,0,248,4
101,Bezirk Affoltern,55111,42,2020,98,0,346,4
101,Bezirk Affoltern,55111,43,2020,140,0,486,4
101,Bezirk Affoltern,55111,44,2020,216,1,702,5
101,Bezirk Affoltern,55111,45,2020,210,0,912,5
101,Bezirk Affoltern,55111,46,2020,122,1,1034,6
101,Bezirk Affoltern,55111,47,2020,120,1,1154,7
101,Bezirk Affoltern,55111,48,2020,149,4,1303,11
101,Bezirk Affoltern,55111,49,2020,162,2,1465,13
101,Bezirk Affoltern,55111,50,2020,189,2,1654,15
101,Bezirk Affoltern,55111,51,2020,200,4,1854,19
101,Bezirk Affoltern,55111,52,2020,182,4,2036,23
101,Bezirk Affoltern,55111,53,2020,153,7,2189,30
101,Bezirk Affoltern,55111,1,2021,115,6,2304,36
101,Bezirk Affoltern,55111,2,2021,84,2,2388,38
101,Bezirk Affoltern,55111,3,2021,69,2,2457,40
101,Bezirk Affoltern,55111,4,2021,61,2,2518,42
101,Bezirk Affoltern,55111,5,2021,51,1,2569,43
101,Bezirk Affoltern,55111,6,2021,46,1,2615,44
101,Bezirk Affoltern,55111,7,2021,34,1,2649,45
101,Bezirk Affoltern,55111,8,2021,38,0,2687,45
101,Bezirk Affoltern,55111,9,2021,61,3,2748,48
101,Bezirk Affoltern,55111,10,2021,42,2,2790,50
101,Bezirk Affoltern,55111,11,2021,40,2,2830,52
101,Bezirk Affoltern,55111,12,2021,59,3,2889,55
101,Bezirk Affoltern,55111,13,2021,56,0,2945,55
101,Bezirk Affoltern,55111,14,2021,70,0,3015,55
101,Bezirk Affoltern,55111,15,2021,49,0,3064,55
101,Bezirk Affoltern,55111,16,2021,83,1,3147,56
101,Bezirk Affoltern,55111,17,2021,70,0,3217,56
101,Bezirk Affoltern,55111,18,2021,34,0,3251,56
101,Bezirk Affoltern,55111,19,2021,40,0,3291,56
101,Bezirk Affoltern,55111,20,2021,32,0,3323,56
101,Bezirk Affoltern,55111,21,2021,22,0,3345,56
101,Bezirk Affoltern,55111,22,2021,13,0,3358,56
101,Bezirk Affoltern,55111,23,2021,17,0,3375,56
101,Bezirk Affoltern,55111,24,2021,10,0,3385,56
101,Bezirk Affoltern,55111,25,2021,4,0,3389,56
101,Bezirk Affoltern,55111,26,2021,6,0,3395,56
101,Bezirk Affoltern,55111,27,2021,10,0,3405,56
101,Bezirk Affoltern,55111,28,2021,24,0,3429,56
101,Bezirk Affoltern,55111,29,2021,29,0,3458,56
101,Bezirk Affoltern,55111,30,2021,27,0,3485,56
101,Bezirk Affoltern,55111,31,2021,22,0,3507,56
101,Bezirk Affoltern,55111,32,2021,45,0,3552,56
101,Bezirk Affoltern,55111,33,2021,86,0,3638,56
101,Bezirk Affoltern,55111,34,2021,105,1,3743,57
101,Bezirk Affoltern,55111,35,2021,120,0,3863,57
101,Bezirk Affoltern,55111,36,2021,139,0,4002,57
101,Bezirk Affoltern,55111,37,2021,123,0,4125,57
101,Bezirk Affoltern,55111,38,2021,51,0,4176,57
101,Bezirk Affoltern,55111,39,2021,41,0,4217,57
101,Bezirk Affoltern,55111,40,2021,37,0,4254,57
101,Bezirk Affoltern,55111,41,2021,33,0,4287,57
101,Bezirk Affoltern,55111,42,2021,46,0,4333,57
101,Bezirk Affoltern,55111,43,2021,50,0,4383,57
101,Bezirk Affoltern,55111,44,2021,127,0,4510,57
101,Bezirk Affoltern,55111,45,2021,188,0,4698,57
101,Bezirk Affoltern,55111,46,2021,212,0,4910,57
101,Bezirk Affoltern,55111,47,2021,439,0,5349,57
101,Bezirk Affoltern,55111,48,2021,433,0,5782,57
101,Bezirk Affoltern,55111,49,2021,400,0,6182,57
101,Bezirk Affoltern,55111,50,2021,281,1,6463,58
101,Bezirk Affoltern,55111,51,2021,346,0,6809,58
101,Bezirk Affoltern,55111,52,2021,514,0,7323,58
101,Bezirk Affoltern,55111,1,2022,774,0,8097,58
101,Bezirk Affoltern,55111,2,2022,974,1,9071,59
101,Bezirk Affoltern,55111,3,2022,1389,1,10460,60
101,Bezirk Affoltern,55111,4,2022,1610,0,12070,60
101,Bezirk Affoltern,55111,5,2022,1490,0,13560,60
101,Bezirk Affoltern,55111,6,2022,1115,0,14675,60
101,Bezirk Affoltern,55111,7,2022,824,0,15499,60
101,Bezirk Affoltern,55111,8,2022,611,0,16110,60
101,Bezirk Affoltern,55111,9,2022,893,0,17003,60
101,Bezirk Affoltern,55111,10,2022,1326,0,18329,60
101,Bezirk Affoltern,55111,11,2022,1475,0,19804,60
101,Bezirk Affoltern,55111,12,2022,1168,1,20972,61
101,Bezirk Affoltern,55111,13,2022,598,0,21570,61
101,Bezirk Affoltern,55111,14,2022,315,0,21885,61
101,Bezirk Affoltern,55111,15,2022,285,0,22170,61
101,Bezirk Affoltern,55111,16,2022,155,0,22325,61
101,Bezirk Affoltern,55111,17,2022,117,0,22442,61
101,Bezirk Affoltern,55111,18,2022,84,0,22526,61
101,Bezirk Affoltern,55111,19,2022,98,0,22624,61
101,Bezirk Affoltern,55111,20,2022,85,0,22709,61
101,Bezirk Affoltern,55111,21,2022,42,0,22751,61
101,Bezirk Affoltern,55111,22,2022,51,0,22802,61
101,Bezirk Affoltern,55111,23,2022,128,0,22930,61
101,Bezirk Affoltern,55111,24,2022,176,0,23106,61
101,Bezirk Affoltern,55111,25,2022,214,0,23320,61
101,Bezirk Affoltern,55111,26,2022,321,0,23641,61
101,Bezirk Affoltern,55111,27,2022,404,0,24045,61
101,Bezirk Affoltern,55111,28,2022,400,0,24445,61
101,Bezirk Affoltern,55111,29,2022,292,0,24737,61
101,Bezirk Affoltern,55111,30,2022,197,0,24934,61
101,Bezirk Affoltern,55111,31,2022,137,0,25071,61
101,Bezirk Affoltern,55111,32,2022,162,0,25233,61
101,Bezirk Affoltern,55111,33,2022,158,0,25391,61
101,Bezirk Affoltern,55111,34,2022,144,0,25535,61
101,Bezirk Affoltern,55111,35,2022,115,0,25650,61
101,Bezirk Affoltern,55111,36,2022,102,0,25752,61
101,Bezirk Affoltern,55111,37,2022,107,0,25859,61
101,Bezirk Affoltern,55111,38,2022,122,0,25981,61
101,Bezirk Affoltern,55111,39,2022,185,0,26166,61
101,Bezirk Affoltern,55111,40,2022,260,0,26426,61
101,Bezirk Affoltern,55111,41,2022,276,0,26702,61
101,Bezirk Affoltern,55111,42,2022,194,0,26896,61
101,Bezirk Affoltern,55111,43,2022,175,0,27071,61
101,Bezirk Affoltern,55111,44,2022,156,0,27227,61
101,Bezirk Affoltern,55111,45,2022,155,0,27382,61
101,Bezirk Affoltern,55111,46,2022,158,0,27540,61
101,Bezirk Affoltern,55111,47,2022,128,0,27668,61
101,Bezirk Affoltern,55111,48,2022,97,0,27765,61
101,Bezirk Affoltern,55111,49,2022,95,0,27860,61
101,Bezirk Affoltern,55111,50,2022,76,0,27936,61
101,Bezirk Affoltern,55111,51,2022,76,0,28012,61
101,Bezirk Affoltern,55111,52,2022,33,0,28045,61
102,Bezirk Andelfingen,31490,9,2020,0,0,0,0
102,Bezirk Andelfingen,31490,10,2020,0,0,0,0
102,Bezirk Andelfingen,31490,11,2020,1,0,1,0
102,Bezirk Andelfingen,31490,12,2020,21,0,22,0
102,Bezirk Andelfingen,31490,13,2020,15,1,37,1
102,Bezirk Andelfingen,31490,14,2020,24,1,61,2
102,Bezirk Andelfingen,31490,15,2020,6,1,67,3
102,Bezirk Andelfingen,31490,16,2020,5,1,72,4
102,Bezirk Andelfingen,31490,17,2020,3,0,75,4
102,Bezirk Andelfingen,31490,18,2020,2,0,77,4
102,Bezirk Andelfingen,31490,19,2020,0,0,77,4
102,Bezirk Andelfingen,31490,20,2020,0,0,77,4
102,Bezirk Andelfingen,31490,21,2020,0,0,77,4
102,Bezirk Andelfingen,31490,22,2020,0,0,77,4
102,Bezirk Andelfingen,31490,23,2020,0,0,77,4
102,Bezirk Andelfingen,31490,24,2020,0,0,77,4
102,Bezirk Andelfingen,31490,25,2020,1,0,78,4
102,Bezirk Andelfingen,31490,26,2020,0,0,78,4
102,Bezirk Andelfingen,31490,27,2020,1,0,79,4
102,Bezirk Andelfingen,31490,28,2020,1,0,80,4
102,Bezirk Andelfingen,31490,29,2020,0,0,80,4
102,Bezirk Andelfingen,31490,30,2020,2,0,82,4
102,Bezirk Andelfingen,31490,31,2020,7,0,89,4
102,Bezirk Andelfingen,31490,32,2020,3,0,92,4
102,Bezirk Andelfingen,31490,33,2020,1,0,93,4
102,Bezirk Andelfingen,31490,34,2020,3,0,96,4
102,Bezirk Andelfingen,31490,35,2020,3,0,99,4
102,Bezirk Andelfingen,31490,36,2020,1,0,100,4
102,Bezirk Andelfingen,31490,37,2020,5,1,105,5
102,Bezirk Andelfingen,31490,38,2020,4,0,109,5
102,Bezirk Andelfingen,31490,39,2020,9,0,118,5
102,Bezirk Andelfingen,31490,40,2020,8,0,126,5
102,Bezirk Andelfingen,31490,41,2020,28,0,154,5
102,Bezirk Andelfingen,31490,42,2020,53,0,207,5
102,Bezirk Andelfingen,31490,43,2020,102,0,309,5
102,Bezirk Andelfingen,31490,44,2020,122,2,431,7
102,Bezirk Andelfingen,31490,45,2020,108,3,539,10
102,Bezirk Andelfingen,31490,46,2020,104,0,643,10
102,Bezirk Andelfingen,31490,47,2020,89,0,732,10
102,Bezirk Andelfingen,31490,48,2020,70,1,802,11
102,Bezirk Andelfingen,31490,49,2020,70,0,872,11
102,Bezirk Andelfingen,31490,50,2020,106,2,978,13
102,Bezirk Andelfingen,31490,51,2020,106,3,1084,16
102,Bezirk Andelfingen,31490,52,2020,95,4,1179,20
102,Bezirk Andelfingen,31490,53,2020,86,2,1265,22
102,Bezirk Andelfingen,31490,1,2021,73,2,1338,24
102,Bezirk Andelfingen,31490,2,2021,29,0,1367,24
102,Bezirk Andelfingen,31490,3,2021,22,0,1389,24
102,Bezirk Andelfingen,31490,4,2021,20,2,1409,26
102,Bezirk Andelfingen,31490,5,2021,17,0,1426,26
102,Bezirk Andelfingen,31490,6,2021,15,0,1441,26
102,Bezirk Andelfingen,31490,7,2021,4,0,1445,26
102,Bezirk Andelfingen,31490,8,2021,11,0,1456,26
102,Bezirk Andelfingen,31490,9,2021,12,0,1468,26
102,Bezirk Andelfingen,31490,10,2021,28,0,1496,26
102,Bezirk Andelfingen,31490,11,2021,14,0,1510,26
102,Bezirk Andelfingen,31490,12,2021,48,0,1558,26
102,Bezirk Andelfingen,31490,13,2021,81,0,1639,26
102,Bezirk Andelfingen,31490,14,2021,47,0,1686,26
102,Bezirk Andelfingen,31490,15,2021,44,0,1730,26
102,Bezirk Andelfingen,31490,16,2021,51,0,1781,26
102,Bezirk Andelfingen,31490,17,2021,34,0,1815,26
102,Bezirk Andelfingen,31490,18,2021,30,0,1845,26
102,Bezirk Andelfingen,31490,19,2021,18,0,1863,26
102,Bezirk Andelfingen,31490,20,2021,26,0,1889,26
102,Bezirk Andelfingen,31490,21,2021,7,0,1896,26
102,Bezirk Andelfingen,31490,22,2021,2,0,1898,26
102,Bezirk Andelfingen,31490,23,2021,4,0,1902,26
102,Bezirk Andelfingen,31490,24,2021,1,0,1903,26
102,Bezirk Andelfingen,31490,25,2021,0,0,1903,26
102,Bezirk Andelfingen,31490,26,2021,2,0,1905,26
102,Bezirk Andelfingen,31490,27,2021,3,0,1908,26
102,Bezirk Andelfingen,31490,28,2021,8,0,1916,26
102,Bezirk Andelfingen,31490,29,2021,17,0,1933,26
102,Bezirk Andelfingen,31490,30,2021,19,0,1952,26
102,Bezirk Andelfingen,31490,31,2021,20,0,1972,26
102,Bezirk Andelfingen,31490,32,2021,41,0,2013,26
102,Bezirk Andelfingen,31490,33,2021,27,0,2040,26
102,Bezirk Andelfingen,31490,34,2021,36,0,2076,26
102,Bezirk Andelfingen,31490,35,2021,38,0,2114,26
102,Bezirk Andelfingen,31490,36,2021,43,0,2157,26
102,Bezirk Andelfingen,31490,37,2021,26,0,2183,26
102,Bezirk Andelfingen,31490,38,2021,29,0,2212,26
102,Bezirk Andelfingen,31490,39,2021,29,0,2241,26
102,Bezirk Andelfingen,31490,40,2021,15,0,2256,26
102,Bezirk Andelfingen,31490,41,2021,17,0,2273,26
102,Bezirk Andelfingen,31490,42,2021,38,0,2311,26
102,Bezirk Andelfingen,31490,43,2021,43,0,2354,26
102,Bezirk Andelfingen,31490,44,2021,88,0,2442,26
102,Bezirk Andelfingen,31490,45,2021,128,0,2570,26
102,Bezirk Andelfingen,31490,46,2021,148,0,2718,26
102,Bezirk Andelfingen,31490,47,2021,201,0,2919,26
102,Bezirk Andelfingen,31490,48,2021,276,0,3195,26
102,Bezirk Andelfingen,31490,49,2021,275,0,3470,26
102,Bezirk Andelfingen,31490,50,2021,207,0,3677,26
102,Bezirk Andelfingen,31490,51,2021,171,0,3848,26
102,Bezirk Andelfingen,31490,52,2021,307,0,4155,26
102,Bezirk Andelfingen,31490,1,2022,514,0,4669,26
102,Bezirk Andelfingen,31490,2,2022,532,0,5201,26
102,Bezirk Andelfingen,31490,3,2022,653,0,5854,26
102,Bezirk Andelfingen,31490,4,2022,785,0,6639,26
102,Bezirk Andelfingen,31490,5,2022,850,0,7489,26
102,Bezirk Andelfingen,31490,6,2022,581,0,8070,26
102,Bezirk Andelfingen,31490,7,2022,520,1,8590,27
102,Bezirk Andelfingen,31490,8,2022,449,0,9039,27
102,Bezirk Andelfingen,31490,9,2022,677,0,9716,27
102,Bezirk Andelfingen,31490,10,2022,823,0,10539,27
102,Bezirk Andelfingen,31490,11,2022,769,1,11308,28
102,Bezirk Andelfingen,31490,12,2022,623,0,11931,28
102,Bezirk Andelfingen,31490,13,2022,338,0,12269,28
102,Bezirk Andelfingen,31490,14,2022,188,0,12457,28
102,Bezirk Andelfingen,31490,15,2022,115,0,12572,28
102,Bezirk Andelfingen,31490,16,2022,86,1,12658,29
102,Bezirk Andelfingen,31490,17,2022,42,0,12700,29
102,Bezirk Andelfingen,31490,18,2022,42,0,12742,29
102,Bezirk Andelfingen,31490,19,2022,31,0,12773,29
102,Bezirk Andelfingen,31490,20,2022,26,0,12799,29
102,Bezirk Andelfingen,31490,21,2022,31,0,12830,29
102,Bezirk Andelfingen,31490,22,2022,38,0,12868,29
102,Bezirk Andelfingen,31490,23,2022,59,0,12927,29
102,Bezirk Andelfingen,31490,24,2022,74,0,13001,29
102,Bezirk Andelfingen,31490,25,2022,106,0,13107,29
102,Bezirk Andelfingen,31490,26,2022,128,0,13235,29
102,Bezirk Andelfingen,31490,27,2022,196,0,13431,29
102,Bezirk Andelfingen,31490,28,2022,196,0,13627,29
102,Bezirk Andelfingen,31490,29,2022,137,0,13764,29
102,Bezirk Andelfingen,31490,30,2022,89,0,13853,29
102,Bezirk Andelfingen,31490,31,2022,50,0,13903,29
102,Bezirk Andelfingen,31490,32,2022,78,0,13981,29
102,Bezirk Andelfingen,31490,33,2022,65,0,14046,29
102,Bezirk Andelfingen,31490,34,2022,44,0,14090,29
102,Bezirk Andelfingen,31490,35,2022,48,0,14138,29
102,Bezirk Andelfingen,31490,36,2022,59,0,14197,29
102,Bezirk Andelfingen,31490,37,2022,67,0,14264,29
102,Bezirk Andelfingen,31490,38,2022,100,0,14364,29
102,Bezirk Andelfingen,31490,39,2022,168,0,14532,29
102,Bezirk Andelfingen,31490,40,2022,205,0,14737,29
102,Bezirk Andelfingen,31490,41,2022,162,0,14899,29
102,Bezirk Andelfingen,31490,42,2022,118,0,15017,29
102,Bezirk Andelfingen,31490,43,2022,108,0,15125,29
102,Bezirk Andelfingen,31490,44,2022,106,0,15231,29
102,Bezirk Andelfingen,31490,45,2022,90,0,15321,29
102,Bezirk Andelfingen,31490,46,2022,93,0,15414,29
102,Bezirk Andelfingen,31490,47,2022,82,0,15496,29
102,Bezirk Andelfingen,31490,48,2022,61,0,15557,29
102,Bezirk Andelfingen,31490,49,2022,67,0,15624,29
102,Bezirk Andelfingen,31490,50,2022,45,1,15669,30
102,Bezirk Andelfingen,31490,51,2022,42,0,15711,30
102,Bezirk Andelfingen,31490,52,2022,15,0,15726,30
103,Bezirk Bülach,154731,9,2020,0,0,0,0
103,Bezirk Bülach,154731,10,2020,4,0,4,0
103,Bezirk Bülach,154731,11,2020,17,0,21,0
103,Bezirk Bülach,154731,12,2020,45,0,66,0
103,Bezirk Bülach,154731,13,2020,51,1,117,1
103,Bezirk Bülach,154731,14,2020,61,2,178,3
103,Bezirk Bülach,154731,15,2020,32,2,210,5
103,Bezirk Bülach,154731,16,2020,23,0,233,5
103,Bezirk Bülach,154731,17,2020,10,0,243,5
103,Bezirk Bülach,154731,18,2020,5,1,248,6
103,Bezirk Bülach,154731,19,2020,4,0,252,6
103,Bezirk Bülach,154731,20,2020,0,0,252,6
103,Bezirk Bülach,154731,21,2020,3,0,255,6
103,Bezirk Bülach,154731,22,2020,5,0,260,6
103,Bezirk Bülach,154731,23,2020,4,0,264,6
103,Bezirk Bülach,154731,24,2020,2,0,266,6
103,Bezirk Bülach,154731,25,2020,13,0,279,6
103,Bezirk Bülach,154731,26,2020,15,0,294,6
103,Bezirk Bülach,154731,27,2020,16,0,310,6
103,Bezirk Bülach,154731,28,2020,31,0,341,6
103,Bezirk Bülach,154731,29,2020,18,0,359,6
103,Bezirk Bülach,154731,30,2020,29,0,388,6
103,Bezirk Bülach,154731,31,2020,17,0,405,6
103,Bezirk Bülach,154731,32,2020,30,0,435,6
103,Bezirk Bülach,154731,33,2020,51,0,486,6
103,Bezirk Bülach,154731,34,2020,49,0,535,6
103,Bezirk Bülach,154731,35,2020,51,0,586,6
103,Bezirk Bülach,154731,36,2020,33,0,619,6
103,Bezirk Bülach,154731,37,2020,40,0,659,6
103,Bezirk Bülach,154731,38,2020,41,0,700,6
103,Bezirk Bülach,154731,39,2020,26,0,726,6
103,Bezirk Bülach,154731,40,2020,46,0,772,6
103,Bezirk Bülach,154731,41,2020,103,0,875,6
103,Bezirk Bülach,154731,42,2020,222,0,1097,6
103,Bezirk Bülach,154731,43,2020,469,2,1566,8
103,Bezirk Bülach,154731,44,2020,576,3,2142,11
103,Bezirk Bülach,154731,45,2020,609,0,2751,11
103,Bezirk Bülach,154731,46,2020,573,3,3324,14
103,Bezirk Bülach,154731,47,2020,541,3,3865,17
103,Bezirk Bülach,154731,48,2020,455,14,4320,31
103,Bezirk Bülach,154731,49,2020,510,7,4830,38
103,Bezirk Bülach,154731,50,2020,590,13,5420,51
103,Bezirk Bülach,154731,51,2020,506,13,5926,64
103,Bezirk Bülach,154731,52,2020,458,8,6384,72
103,Bezirk Bülach,154731,53,2020,425,11,6809,83
103,Bezirk Bülach,154731,1,2021,391,3,7200,86
103,Bezirk Bülach,154731,2,2021,267,4,7467,90
103,Bezirk Bülach,154731,3,2021,238,5,7705,95
103,Bezirk Bülach,154731,4,2021,203,4,7908,99
103,Bezirk Bülach,154731,5,2021,147,5,8055,104
103,Bezirk Bülach,154731,6,2021,118,4,8173,108
103,Bezirk Bülach,154731,7,2021,119,2,8292,110
103,Bezirk Bülach,154731,8,2021,104,1,8396,111
103,Bezirk Bülach,154731,9,2021,131,0,8527,111
103,Bezirk Bülach,154731,10,2021,168,2,8695,113
103,Bezirk Bülach,154731,11,2021,203,0,8898,113
103,Bezirk Bülach,154731,12,2021,274,1,9172,114
103,Bezirk Bülach,154731,13,2021,236,0,9408,114
103,Bezirk Bülach,154731,14,2021,391,0,9799,114
103,Bezirk Bülach,154731,15,2021,387,1,10186,115
103,Bezirk Bülach,154731,16,2021,292,2,10478,117
103,Bezirk Bülach,154731,17,2021,279,0,10757,117
103,Bezirk Bülach,154731,18,2021,183,0,10940,117
103,Bezirk Bülach,154731,19,2021,143,1,11083,118
103,Bezirk Bülach,154731,20,2021,116,0,11199,118
103,Bezirk Bülach,154731,21,2021,76,1,11275,119
103,Bezirk Bülach,154731,22,2021,41,0,11316,119
103,Bezirk Bülach,154731,23,2021,43,1,11359,120
103,Bezirk Bülach,154731,24,2021,23,3,11382,123
103,Bezirk Bülach,154731,25,2021,16,1,11398,124
103,Bezirk Bülach,154731,26,2021,15,0,11413,124
103,Bezirk Bülach,154731,27,2021,35,0,11448,124
103,Bezirk Bülach,154731,28,2021,104,0,11552,124
103,Bezirk Bülach,154731,29,2021,82,0,11634,124
103,Bezirk Bülach,154731,30,2021,100,0,11734,124
103,Bezirk Bülach,154731,31,2021,114,0,11848,124
103,Bezirk Bülach,154731,32,2021,264,0,12112,124
103,Bezirk Bülach,154731,33,2021,358,0,12470,124
103,Bezirk Bülach,154731,34,2021,405,0,12875,124
103,Bezirk Bülach,154731,35,2021,356,1,13231,125
103,Bezirk Bülach,154731,36,2021,460,2,13691,127
103,Bezirk Bülach,154731,37,2021,270,1,13961,128
103,Bezirk Bülach,154731,38,2021,210,0,14171,128
103,Bezirk Bülach,154731,39,2021,149,0,14320,128
103,Bezirk Bülach,154731,40,2021,142,0,14462,128
103,Bezirk Bülach,154731,41,2021,105,1,14567,129
103,Bezirk Bülach,154731,42,2021,137,0,14704,129
103,Bezirk Bülach,154731,43,2021,166,2,14870,131
103,Bezirk Bülach,154731,44,2021,320,0,15190,131
103,Bezirk Bülach,154731,45,2021,464,0,15654,131
103,Bezirk Bülach,154731,46,2021,537,0,16191,131
103,Bezirk Bülach,154731,47,2021,757,0,16948,131
103,Bezirk Bülach,154731,48,2021,935,0,17883,131
103,Bezirk Bülach,154731,49,2021,1089,2,18972,133
103,Bezirk Bülach,154731,50,2021,987,5,19959,138
103,Bezirk Bülach,154731,51,2021,914,5,20873,143
103,Bezirk Bülach,154731,52,2021,1416,1,22289,144
103,Bezirk Bülach,154731,1,2022,2565,1,24854,145
103,Bezirk Bülach,154731,2,2022,2977,2,27831,147
103,Bezirk Bülach,154731,3,2022,3800,1,31631,148
103,Bezirk Bülach,154731,4,2022,4251,1,35882,149
103,Bezirk Bülach,154731,5,2022,3739,2,39621,151
103,Bezirk Bülach,154731,6,2022,2995,0,42616,151
103,Bezirk Bülach,154731,7,2022,2012,0,44628,151
103,Bezirk Bülach,154731,8,2022,1627,2,46255,153
103,Bezirk Bülach,154731,9,2022,2537,3,48792,156
103,Bezirk Bülach,154731,10,2022,3788,0,52580,156
103,Bezirk Bülach,154731,11,2022,4125,0,56705,156
103,Bezirk Bülach,154731,12,2022,3418,3,60123,159
103,Bezirk Bülach,154731,13,2022,1717,1,61840,160
103,Bezirk Bülach,154731,14,2022,891,2,62731,162
103,Bezirk Bülach,154731,15,2022,670,0,63401,162
103,Bezirk Bülach,154731,16,2022,482,0,63883,162
103,Bezirk Bülach,154731,17,2022,382,0,64265,162
103,Bezirk Bülach,154731,18,2022,286,0,64551,162
103,Bezirk Bülach,154731,19,2022,205,0,64756,162
103,Bezirk Bülach,154731,20,2022,131,0,64887,162
103,Bezirk Bülach,154731,21,2022,105,2,64992,164
103,Bezirk Bülach,154731,22,2022,226,0,65218,164
103,Bezirk Bülach,154731,23,2022,276,0,65494,164
103,Bezirk Bülach,154731,24,2022,458,0,65952,164
103,Bezirk Bülach,154731,25,2022,633,0,66585,164
103,Bezirk Bülach,154731,26,2022,986,1,67571,165
103,Bezirk Bülach,154731,27,2022,1198,0,68769,165
103,Bezirk Bülach,154731,28,2022,1046,0,69815,165
103,Bezirk Bülach,154731,29,2022,833,3,70648,168
103,Bezirk Bülach,154731,30,2022,532,2,71180,170
103,Bezirk Bülach,154731,31,2022,366,1,71546,171
103,Bezirk Bülach,154731,32,2022,402,1,71948,172
103,Bezirk Bülach,154731,33,2022,340,0,72288,172
103,Bezirk Bülach,154731,34,2022,288,0,72576,172
103,Bezirk Bülach,154731,35,2022,267,1,72843,173
103,Bezirk Bülach,154731,36,2022,239,0,73082,173
103,Bezirk Bülach,154731,37,2022,273,0,73355,173
103,Bezirk Bülach,154731,38,2022,318,0,73673,173
103,Bezirk Bülach,154731,39,2022,435,0,74108,173
103,Bezirk Bülach,154731,40,2022,671,0,74779,173
103,Bezirk Bülach,154731,41,2022,696,0,75475,173
103,Bezirk Bülach,154731,42,2022,550,0,76025,173
103,Bezirk Bülach,154731,43,2022,426,0,76451,173
103,Bezirk Bülach,154731,44,2022,439,0,76890,173
103,Bezirk Bülach,154731,45,2022,416,0,77306,173
103,Bezirk Bülach,154731,46,2022,407,0,77713,173
103,Bezirk Bülach,154731,47,2022,339,0,78052,173
103,Bezirk Bülach,154731,48,2022,331,0,78383,173
103,Bezirk Bülach,154731,49,2022,286,2,78669,175
103,Bezirk Bülach,154731,50,2022,212,1,78881,176
103,Bezirk Bülach,154731,51,2022,192,0,79073,176
103,Bezirk Bülach,154731,52,2022,105,0,79178,176
104,Bezirk Dielsdorf,91112,9,2020,0,0,0,0
104,Bezirk Dielsdorf,91112,10,2020,0,0,0,0
104,Bezirk Dielsdorf,91112,11,2020,13,0,13,0
104,Bezirk Dielsdorf,91112,12,2020,31,0,44,0
104,Bezirk Dielsdorf,91112,13,2020,36,0,80,0
104,Bezirk Dielsdorf,91112,14,2020,39,1,119,1
104,Bezirk Dielsdorf,91112,15,2020,39,0,158,1
104,Bezirk Dielsdorf,91112,16,2020,9,3,167,4
104,Bezirk Dielsdorf,91112,17,2020,4,0,171,4
104,Bezirk Dielsdorf,91112,18,2020,4,0,175,4
104,Bezirk Dielsdorf,91112,19,2020,4,0,179,4
104,Bezirk Dielsdorf,91112,20,2020,2,0,181,4
104,Bezirk Dielsdorf,91112,21,2020,1,0,182,4
104,Bezirk Dielsdorf,91112,22,2020,4,0,186,4
104,Bezirk Dielsdorf,91112,23,2020,0,0,186,4
104,Bezirk Dielsdorf,91112,24,2020,1,0,187,4
104,Bezirk Dielsdorf,91112,25,2020,2,0,189,4
104,Bezirk Dielsdorf,91112,26,2020,4,0,193,4
104,Bezirk Dielsdorf,91112,27,2020,10,0,203,4
104,Bezirk Dielsdorf,91112,28,2020,6,0,209,4
104,Bezirk Dielsdorf,91112,29,2020,10,0,219,4
104,Bezirk Dielsdorf,91112,30,2020,6,0,225,4
104,Bezirk Dielsdorf,91112,31,2020,10,0,235,4
104,Bezirk Dielsdorf,91112,32,2020,13,0,248,4
104,Bezirk Dielsdorf,91112,33,2020,29,0,277,4
104,Bezirk Dielsdorf,91112,34,2020,8,0,285,4
104,Bezirk Dielsdorf,91112,35,2020,26,0,311,4
104,Bezirk Dielsdorf,91112,36,2020,24,0,335,4
104,Bezirk Dielsdorf,91112,37,2020,24,0,359,4
104,Bezirk Dielsdorf,91112,38,2020,28,0,387,4
104,Bezirk Dielsdorf,91112,39,2020,21,0,408,4
104,Bezirk Dielsdorf,91112,40,2020,23,0,431,4
104,Bezirk Dielsdorf,91112,41,2020,34,0,465,4
104,Bezirk Dielsdorf,91112,42,2020,109,0,574,4
104,Bezirk Dielsdorf,91112,43,2020,242,0,816,4
104,Bezirk Dielsdorf,91112,44,2020,339,0,1155,4
104,Bezirk Dielsdorf,91112,45,2020,361,2,1516,6
104,Bezirk Dielsdorf,91112,46,2020,334,4,1850,10
104,Bezirk Dielsdorf,91112,47,2020,338,2,2188,12
104,Bezirk Dielsdorf,91112,48,2020,257,2,2445,14
104,Bezirk Dielsdorf,91112,49,2020,294,2,2739,16
104,Bezirk Dielsdorf,91112,50,2020,326,1,3065,17
104,Bezirk Dielsdorf,91112,51,2020,340,2,3405,19
104,Bezirk Dielsdorf,91112,52,2020,259,5,3664,24
104,Bezirk Dielsdorf,91112,53,2020,290,5,3954,29
104,Bezirk Dielsdorf,91112,1,2021,239,3,4193,32
104,Bezirk Dielsdorf,91112,2,2021,158,4,4351,36
104,Bezirk Dielsdorf,91112,3,2021,140,0,4491,36
104,Bezirk Dielsdorf,91112,4,2021,91,3,4582,39
104,Bezirk Dielsdorf,91112,5,2021,82,0,4664,39
104,Bezirk Dielsdorf,91112,6,2021,69,6,4733,45
104,Bezirk Dielsdorf,91112,7,2021,60,1,4793,46
104,Bezirk Dielsdorf,91112,8,2021,74,0,4867,46
104,Bezirk Dielsdorf,91112,9,2021,90,1,4957,47
104,Bezirk Dielsdorf,91112,10,2021,131,0,5088,47
104,Bezirk Dielsdorf,91112,11,2021,144,4,5232,51
104,Bezirk Dielsdorf,91112,12,2021,186,1,5418,52
104,Bezirk Dielsdorf,91112,13,2021,143,1,5561,53
104,Bezirk Dielsdorf,91112,14,2021,173,0,5734,53
104,Bezirk Dielsdorf,91112,15,2021,167,0,5901,53
104,Bezirk Dielsdorf,91112,16,2021,179,0,6080,53
104,Bezirk Dielsdorf,91112,17,2021,142,0,6222,53
104,Bezirk Dielsdorf,91112,18,2021,100,0,6322,53
104,Bezirk Dielsdorf,91112,19,2021,59,0,6381,53
104,Bezirk Dielsdorf,91112,20,2021,71,0,6452,53
104,Bezirk Dielsdorf,91112,21,2021,35,0,6487,53
104,Bezirk Dielsdorf,91112,22,2021,33,0,6520,53
104,Bezirk Dielsdorf,91112,23,2021,14,1,6534,54
104,Bezirk Dielsdorf,91112,24,2021,8,0,6542,54
104,Bezirk Dielsdorf,91112,25,2021,5,0,6547,54
104,Bezirk Dielsdorf,91112,26,2021,12,0,6559,54
104,Bezirk Dielsdorf,91112,27,2021,21,0,6580,54
104,Bezirk Dielsdorf,91112,28,2021,34,0,6614,54
104,Bezirk Dielsdorf,91112,29,2021,86,0,6700,54
104,Bezirk Dielsdorf,91112,30,2021,57,0,6757,54
104,Bezirk Dielsdorf,91112,31,2021,66,0,6823,54
104,Bezirk Dielsdorf,91112,32,2021,175,0,6998,54
104,Bezirk Dielsdorf,91112,33,2021,287,2,7285,56
104,Bezirk Dielsdorf,91112,34,2021,273,2,7558,58
104,Bezirk Dielsdorf,91112,35,2021,287,1,7845,59
104,Bezirk Dielsdorf,91112,36,2021,281,0,8126,59
104,Bezirk Dielsdorf,91112,37,2021,226,0,8352,59
104,Bezirk Dielsdorf,91112,38,2021,136,0,8488,59
104,Bezirk Dielsdorf,91112,39,2021,87,0,8575,59
104,Bezirk Dielsdorf,91112,40,2021,71,0,8646,59
104,Bezirk Dielsdorf,91112,41,2021,43,0,8689,59
104,Bezirk Dielsdorf,91112,42,2021,51,1,8740,60
104,Bezirk Dielsdorf,91112,43,2021,101,0,8841,60
104,Bezirk Dielsdorf,91112,44,2021,148,0,8989,60
104,Bezirk Dielsdorf,91112,45,2021,286,0,9275,60
104,Bezirk Dielsdorf,91112,46,2021,312,0,9587,60
104,Bezirk Dielsdorf,91112,47,2021,406,5,9993,65
104,Bezirk Dielsdorf,91112,48,2021,562,2,10555,67
104,Bezirk Dielsdorf,91112,49,2021,613,0,11168,67
104,Bezirk Dielsdorf,91112,50,2021,464,1,11632,68
104,Bezirk Dielsdorf,91112,51,2021,431,0,12063,68
104,Bezirk Dielsdorf,91112,52,2021,719,1,12782,69
104,Bezirk Dielsdorf,91112,1,2022,1467,0,14249,69
104,Bezirk Dielsdorf,91112,2,2022,1838,0,16087,69
104,Bezirk Dielsdorf,91112,3,2022,2387,0,18474,69
104,Bezirk Dielsdorf,91112,4,2022,2704,0,21178,69
104,Bezirk Dielsdorf,91112,5,2022,2275,0,23453,69
104,Bezirk Dielsdorf,91112,6,2022,1746,1,25199,70
104,Bezirk Dielsdorf,91112,7,2022,1234,0,26433,70
104,Bezirk Dielsdorf,91112,8,2022,942,0,27375,70
104,Bezirk Dielsdorf,91112,9,2022,1248,1,28623,71
104,Bezirk Dielsdorf,91112,10,2022,1744,0,30367,71
104,Bezirk Dielsdorf,91112,11,2022,2082,1,32449,72
104,Bezirk Dielsdorf,91112,12,2022,1823,0,34272,72
104,Bezirk Dielsdorf,91112,13,2022,931,4,35203,76
104,Bezirk Dielsdorf,91112,14,2022,400,0,35603,76
104,Bezirk Dielsdorf,91112,15,2022,395,0,35998,76
104,Bezirk Dielsdorf,91112,16,2022,207,0,36205,76
104,Bezirk Dielsdorf,91112,17,2022,137,0,36342,76
104,Bezirk Dielsdorf,91112,18,2022,141,0,36483,76
104,Bezirk Dielsdorf,91112,19,2022,128,0,36611,76
104,Bezirk Dielsdorf,91112,20,2022,80,0,36691,76
104,Bezirk Dielsdorf,91112,21,2022,74,0,36765,76
104,Bezirk Dielsdorf,91112,22,2022,104,0,36869,76
104,Bezirk Dielsdorf,91112,23,2022,199,0,37068,76
104,Bezirk Dielsdorf,91112,24,2022,240,0,37308,76
104,Bezirk Dielsdorf,91112,25,2022,356,0,37664,76
104,Bezirk Dielsdorf,91112,26,2022,495,0,38159,76
104,Bezirk Dielsdorf,91112,27,2022,604,0,38763,76
104,Bezirk Dielsdorf,91112,28,2022,553,2,39316,78
104,Bezirk Dielsdorf,91112,29,2022,454,0,39770,78
104,Bezirk Dielsdorf,91112,30,2022,292,1,40062,79
104,Bezirk Dielsdorf,91112,31,2022,213,1,40275,80
104,Bezirk Dielsdorf,91112,32,2022,242,1,40517,81
104,Bezirk Dielsdorf,91112,33,2022,210,0,40727,81
104,Bezirk Dielsdorf,91112,34,2022,160,1,40887,82
104,Bezirk Dielsdorf,91112,35,2022,148,1,41035,83
104,Bezirk Dielsdorf,91112,36,2022,119,0,41154,83
104,Bezirk Dielsdorf,91112,37,2022,139,0,41293,83
104,Bezirk Dielsdorf,91112,38,2022,162,0,41455,83
104,Bezirk Dielsdorf,91112,39,2022,253,0,41708,83
104,Bezirk Dielsdorf,91112,40,2022,345,0,42053,83
104,Bezirk Dielsdorf,91112,41,2022,339,0,42392,83
104,Bezirk Dielsdorf,91112,42,2022,266,0,42658,83
104,Bezirk Dielsdorf,91112,43,2022,223,0,42881,83
104,Bezirk Dielsdorf,91112,44,2022,211,0,43092,83
104,Bezirk Dielsdorf,91112,45,2022,216,0,43308,83
104,Bezirk Dielsdorf,91112,46,2022,187,0,43495,83
104,Bezirk Dielsdorf,91112,47,2022,162,0,43657,83
104,Bezirk Dielsdorf,91112,48,2022,180,0,43837,83
104,Bezirk Dielsdorf,91112,49,2022,150,0,43987,83
104,Bezirk Dielsdorf,91112,50,2022,151,0,44138,83
104,Bezirk Dielsdorf,91112,51,2022,96,0,44234,83
104,Bezirk Dielsdorf,91112,52,2022,44,0,44278,83
105,Bezirk Hinwil,96595,9,2020,0,0,0,0
105,Bezirk Hinwil,96595,10,2020,2,0,2,0
105,Bezirk Hinwil,96595,11,2020,7,0,9,0
105,Bezirk Hinwil,96595,12,2020,32,0,41,0
105,Bezirk Hinwil,96595,13,2020,43,0,84,0
105,Bezirk Hinwil,96595,14,2020,31,0,115,0
105,Bezirk Hinwil,96595,15,2020,38,0,153,0
105,Bezirk Hinwil,96595,16,2020,14,0,167,0
105,Bezirk Hinwil,96595,17,2020,7,0,174,0
105,Bezirk Hinwil,96595,18,2020,5,0,179,0
105,Bezirk Hinwil,96595,19,2020,3,0,182,0
105,Bezirk Hinwil,96595,20,2020,0,0,182,0
105,Bezirk Hinwil,96595,21,2020,2,0,184,0
105,Bezirk Hinwil,96595,22,2020,0,0,184,0
105,Bezirk Hinwil,96595,23,2020,2,0,186,0
105,Bezirk Hinwil,96595,24,2020,0,0,186,0
105,Bezirk Hinwil,96595,25,2020,0,0,186,0
105,Bezirk Hinwil,96595,26,2020,3,0,189,0
105,Bezirk Hinwil,96595,27,2020,16,0,205,0
105,Bezirk Hinwil,96595,28,2020,9,0,214,0
105,Bezirk Hinwil,96595,29,2020,16,0,230,0
105,Bezirk Hinwil,96595,30,2020,14,0,244,0
105,Bezirk Hinwil,96595,31,2020,19,0,263,0
105,Bezirk Hinwil,96595,32,2020,17,0,280,0
105,Bezirk Hinwil,96595,33,2020,7,0,287,0
105,Bezirk Hinwil,96595,34,2020,11,0,298,0
105,Bezirk Hinwil,96595,35,2020,29,0,327,0
105,Bezirk Hinwil,96595,36,2020,17,0,344,0
105,Bezirk Hinwil,96595,37,2020,21,1,365,1
105,Bezirk Hinwil,96595,38,2020,18,0,383,1
105,Bezirk Hinwil,96595,39,2020,6,0,389,1
105,Bezirk Hinwil,96595,40,2020,20,0,409,1
105,Bezirk Hinwil,96595,41,2020,42,0,451,1
105,Bezirk Hinwil,96595,42,2020,137,0,588,1
105,Bezirk Hinwil,96595,43,2020,218,0,806,1
105,Bezirk Hinwil,96595,44,2020,393,2,1199,3
105,Bezirk Hinwil,96595,45,2020,399,5,1598,8
105,Bezirk Hinwil,96595,46,2020,313,11,1911,19
105,Bezirk Hinwil,96595,47,2020,352,4,2263,23
105,Bezirk Hinwil,96595,48,2020,315,9,2578,32
105,Bezirk Hinwil,96595,49,2020,387,13,2965,45
105,Bezirk Hinwil,96595,50,2020,445,10,3410,55
105,Bezirk Hinwil,96595,51,2020,520,6,3930,61
105,Bezirk Hinwil,96595,52,2020,411,5,4341,66
105,Bezirk Hinwil,96595,53,2020,377,6,4718,72
105,Bezirk Hinwil,96595,1,2021,338,1,5056,73
105,Bezirk Hinwil,96595,2,2021,205,6,5261,79
105,Bezirk Hinwil,96595,3,2021,198,4,5459,83
105,Bezirk Hinwil,96595,4,2021,132,2,5591,85
105,Bezirk Hinwil,96595,5,2021,118,2,5709,87
105,Bezirk Hinwil,96595,6,2021,73,2,5782,89
105,Bezirk Hinwil,96595,7,2021,54,2,5836,91
105,Bezirk Hinwil,96595,8,2021,45,0,5881,91
105,Bezirk Hinwil,96595,9,2021,62,0,5943,91
105,Bezirk Hinwil,96595,10,2021,95,1,6038,92
105,Bezirk Hinwil,96595,11,2021,136,1,6174,93
105,Bezirk Hinwil,96595,12,2021,174,1,6348,94
105,Bezirk Hinwil,96595,13,2021,201,0,6549,94
105,Bezirk Hinwil,96595,14,2021,270,2,6819,96
105,Bezirk Hinwil,96595,15,2021,219,0,7038,96
105,Bezirk Hinwil,96595,16,2021,176,0,7214,96
105,Bezirk Hinwil,96595,17,2021,148,0,7362,96
105,Bezirk Hinwil,96595,18,2021,94,2,7456,98
105,Bezirk Hinwil,96595,19,2021,65,0,7521,98
105,Bezirk Hinwil,96595,20,2021,79,1,7600,99
105,Bezirk Hinwil,96595,21,2021,41,0,7641,99
105,Bezirk Hinwil,96595,22,2021,38,0,7679,99
105,Bezirk Hinwil,96595,23,2021,33,0,7712,99
105,Bezirk Hinwil,96595,24,2021,17,1,7729,100
105,Bezirk Hinwil,96595,25,2021,12,0,7741,100
105,Bezirk Hinwil,96595,26,2021,7,1,7748,101
105,Bezirk Hinwil,96595,27,2021,32,0,7780,101
105,Bezirk Hinwil,96595,28,2021,65,0,7845,101
105,Bezirk Hinwil,96595,29,2021,94,0,7939,101
105,Bezirk Hinwil,96595,30,2021,60,0,7999,101
105,Bezirk Hinwil,96595,31,2021,62,0,8061,101
105,Bezirk Hinwil,96595,32,2021,162,0,8223,101
105,Bezirk Hinwil,96595,33,2021,279,0,8502,101
105,Bezirk Hinwil,96595,34,2021,243,0,8745,101
105,Bezirk Hinwil,96595,35,2021,324,1,9069,102
105,Bezirk Hinwil,96595,36,2021,346,2,9415,104
105,Bezirk Hinwil,96595,37,2021,221,0,9636,104
105,Bezirk Hinwil,96595,38,2021,161,1,9797,105
105,Bezirk Hinwil,96595,39,2021,122,2,9919,107
105,Bezirk Hinwil,96595,40,2021,104,0,10023,107
105,Bezirk Hinwil,96595,41,2021,99,0,10122,107
105,Bezirk Hinwil,96595,42,2021,140,0,10262,107
105,Bezirk Hinwil,96595,43,2021,140,0,10402,107
105,Bezirk Hinwil,96595,44,2021,207,0,10609,107
105,Bezirk Hinwil,96595,45,2021,265,0,10874,107
105,Bezirk Hinwil,96595,46,2021,483,0,11357,107
105,Bezirk Hinwil,96595,47,2021,800,1,12157,108
105,Bezirk Hinwil,96595,48,2021,816,1,12973,109
105,Bezirk Hinwil,96595,49,2021,931,1,13904,110
105,Bezirk Hinwil,96595,50,2021,715,3,14619,113
105,Bezirk Hinwil,96595,51,2021,682,1,15301,114
105,Bezirk Hinwil,96595,52,2021,901,1,16202,115
105,Bezirk Hinwil,96595,1,2022,1418,0,17620,115
105,Bezirk Hinwil,96595,2,2022,1466,0,19086,115
105,Bezirk Hinwil,96595,3,2022,2070,0,21156,115
105,Bezirk Hinwil,96595,4,2022,2324,0,23480,115
105,Bezirk Hinwil,96595,5,2022,2464,1,25944,116
105,Bezirk Hinwil,96595,6,2022,2090,1,28034,117
105,Bezirk Hinwil,96595,7,2022,1503,0,29537,117
105,Bezirk Hinwil,96595,8,2022,1164,0,30701,117
105,Bezirk Hinwil,96595,9,2022,1549,1,32250,118
105,Bezirk Hinwil,96595,10,2022,2257,0,34507,118
105,Bezirk Hinwil,96595,11,2022,2684,0,37191,118
105,Bezirk Hinwil,96595,12,2022,1948,1,39139,119
105,Bezirk Hinwil,96595,13,2022,959,0,40098,119
105,Bezirk Hinwil,96595,14,2022,517,0,40615,119
105,Bezirk Hinwil,96595,15,2022,400,0,41015,119
105,Bezirk Hinwil,96595,16,2022,266,0,41281,119
105,Bezirk Hinwil,96595,17,2022,191,0,41472,119
105,Bezirk Hinwil,96595,18,2022,159,1,41631,120
105,Bezirk Hinwil,96595,19,2022,134,0,41765,120
105,Bezirk Hinwil,96595,20,2022,111,0,41876,120
105,Bezirk Hinwil,96595,21,2022,87,0,41963,120
105,Bezirk Hinwil,96595,22,2022,112,0,42075,120
105,Bezirk Hinwil,96595,23,2022,149,0,42224,120
105,Bezirk Hinwil,96595,24,2022,221,0,42445,120
105,Bezirk Hinwil,96595,25,2022,322,0,42767,120
105,Bezirk Hinwil,96595,26,2022,423,0,43190,120
105,Bezirk Hinwil,96595,27,2022,649,0,43839,120
105,Bezirk Hinwil,96595,28,2022,604,0,44443,120
105,Bezirk Hinwil,96595,29,2022,501,0,44944,120
105,Bezirk Hinwil,96595,30,2022,295,0,45239,120
105,Bezirk Hinwil,96595,31,2022,183,1,45422,121
105,Bezirk Hinwil,96595,32,2022,239,0,45661,121
105,Bezirk Hinwil,96595,33,2022,244,0,45905,121
105,Bezirk Hinwil,96595,34,2022,190,0,46095,121
105,Bezirk Hinwil,96595,35,2022,189,0,46284,121
105,Bezirk Hinwil,96595,36,2022,238,2,46522,123
105,Bezirk Hinwil,96595,37,2022,173,0,46695,123
105,Bezirk Hinwil,96595,38,2022,189,0,46884,123
105,Bezirk Hinwil,96595,39,2022,298,0,47182,123
105,Bezirk Hinwil,96595,40,2022,420,0,47602,123
105,Bezirk Hinwil,96595,41,2022,466,0,48068,123
105,Bezirk Hinwil,96595,42,2022,375,0,48443,123
105,Bezirk Hinwil,96595,43,2022,265,0,48708,123
105,Bezirk Hinwil,96595,44,2022,239,0,48947,123
105,Bezirk Hinwil,96595,45,2022,273,0,49220,123
105,Bezirk Hinwil,96595,46,2022,238,0,49458,123
105,Bezirk Hinwil,96595,47,2022,182,0,49640,123
105,Bezirk Hinwil,96595,48,2022,164,0,49804,123
105,Bezirk Hinwil,96595,49,2022,159,0,49963,123
105,Bezirk Hinwil,96595,50,2022,173,0,50136,123
105,Bezirk Hinwil,96595,51,2022,132,0,50268,123
105,Bezirk Hinwil,96595,52,2022,62,0,50330,123
106,Bezirk Horgen,125834,9,2020,0,0,0,0
106,Bezirk Horgen,125834,10,2020,2,0,2,0
106,Bezirk Horgen,125834,11,2020,17,0,19,0
106,Bezirk Horgen,125834,12,2020,69,0,88,0
106,Bezirk Horgen,125834,13,2020,55,4,143,4
106,Bezirk Horgen,125834,14,2020,59,1,202,5
106,Bezirk Horgen,125834,15,2020,24,1,226,6
106,Bezirk Horgen,125834,16,2020,8,1,234,7
106,Bezirk Horgen,125834,17,2020,7,1,241,8
106,Bezirk Horgen,125834,18,2020,4,0,245,8
106,Bezirk Horgen,125834,19,2020,4,0,249,8
106,Bezirk Horgen,125834,20,2020,3,0,252,8
106,Bezirk Horgen,125834,21,2020,3,0,255,8
106,Bezirk Horgen,125834,22,2020,0,0,255,8
106,Bezirk Horgen,125834,23,2020,0,0,255,8
106,Bezirk Horgen,125834,24,2020,0,0,255,8
106,Bezirk Horgen,125834,25,2020,0,0,255,8
106,Bezirk Horgen,125834,26,2020,5,0,260,8
106,Bezirk Horgen,125834,27,2020,16,0,276,8
106,Bezirk Horgen,125834,28,2020,10,0,286,8
106,Bezirk Horgen,125834,29,2020,9,0,295,8
106,Bezirk Horgen,125834,30,2020,14,1,309,9
106,Bezirk Horgen,125834,31,2020,6,0,315,9
106,Bezirk Horgen,125834,32,2020,7,0,322,9
106,Bezirk Horgen,125834,33,2020,22,0,344,9
106,Bezirk Horgen,125834,34,2020,28,0,372,9
106,Bezirk Horgen,125834,35,2020,29,0,401,9
106,Bezirk Horgen,125834,36,2020,28,0,429,9
106,Bezirk Horgen,125834,37,2020,24,0,453,9
106,Bezirk Horgen,125834,38,2020,32,0,485,9
106,Bezirk Horgen,125834,39,2020,29,0,514,9
106,Bezirk Horgen,125834,40,2020,49,0,563,9
106,Bezirk Horgen,125834,41,2020,106,0,669,9
106,Bezirk Horgen,125834,42,2020,282,1,951,10
106,Bezirk Horgen,125834,43,2020,395,0,1346,10
106,Bezirk Horgen,125834,44,2020,533,0,1879,10
106,Bezirk Horgen,125834,45,2020,459,2,2338,12
106,Bezirk Horgen,125834,46,2020,441,6,2779,18
106,Bezirk Horgen,125834,47,2020,394,5,3173,23
106,Bezirk Horgen,125834,48,2020,461,8,3634,31
106,Bezirk Horgen,125834,49,2020,397,16,4031,47
106,Bezirk Horgen,125834,50,2020,458,14,4489,61
106,Bezirk Horgen,125834,51,2020,420,9,4909,70
106,Bezirk Horgen,125834,52,2020,345,7,5254,77
106,Bezirk Horgen,125834,53,2020,304,6,5558,83
106,Bezirk Horgen,125834,1,2021,303,7,5861,90
106,Bezirk Horgen,125834,2,2021,208,3,6069,93
106,Bezirk Horgen,125834,3,2021,198,5,6267,98
106,Bezirk Horgen,125834,4,2021,201,5,6468,103
106,Bezirk Horgen,125834,5,2021,151,3,6619,106
106,Bezirk Horgen,125834,6,2021,165,4,6784,110
106,Bezirk Horgen,125834,7,2021,78,2,6862,112
106,Bezirk Horgen,125834,8,2021,63,2,6925,114
106,Bezirk Horgen,125834,9,2021,72,3,6997,117
106,Bezirk Horgen,125834,10,2021,118,0,7115,117
106,Bezirk Horgen,125834,11,2021,137,0,7252,117
106,Bezirk Horgen,125834,12,2021,151,0,7403,117
106,Bezirk Horgen,125834,13,2021,184,2,7587,119
106,Bezirk Horgen,125834,14,2021,227,3,7814,122
106,Bezirk Horgen,125834,15,2021,225,2,8039,124
106,Bezirk Horgen,125834,16,2021,217,2,8256,126
106,Bezirk Horgen,125834,17,2021,125,0,8381,126
106,Bezirk Horgen,125834,18,2021,110,0,8491,126
106,Bezirk Horgen,125834,19,2021,76,0,8567,126
106,Bezirk Horgen,125834,20,2021,66,1,8633,127
106,Bezirk Horgen,125834,21,2021,48,0,8681,127
106,Bezirk Horgen,125834,22,2021,31,0,8712,127
106,Bezirk Horgen,125834,23,2021,24,0,8736,127
106,Bezirk Horgen,125834,24,2021,14,0,8750,127
106,Bezirk Horgen,125834,25,2021,9,0,8759,127
106,Bezirk Horgen,125834,26,2021,12,0,8771,127
106,Bezirk Horgen,125834,27,2021,34,0,8805,127
106,Bezirk Horgen,125834,28,2021,72,0,8877,127
106,Bezirk Horgen,125834,29,2021,82,0,8959,127
106,Bezirk Horgen,125834,30,2021,70,0,9029,127
106,Bezirk Horgen,125834,31,2021,85,0,9114,127
106,Bezirk Horgen,125834,32,2021,180,0,9294,127
106,Bezirk Horgen,125834,33,2021,211,0,9505,127
106,Bezirk Horgen,125834,34,2021,231,1,9736,128
106,Bezirk Horgen,125834,35,2021,204,0,9940,128
106,Bezirk Horgen,125834,36,2021,183,1,10123,129
106,Bezirk Horgen,125834,37,2021,158,0,10281,129
106,Bezirk Horgen,125834,38,2021,98,0,10379,129
106,Bezirk Horgen,125834,39,2021,119,0,10498,129
106,Bezirk Horgen,125834,40,2021,94,0,10592,129
106,Bezirk Horgen,125834,41,2021,62,2,10654,131
106,Bezirk Horgen,125834,42,2021,110,0,10764,131
106,Bezirk Horgen,125834,43,2021,117,0,10881,131
106,Bezirk Horgen,125834,44,2021,252,0,11133,131
106,Bezirk Horgen,125834,45,2021,409,0,11542,131
106,Bezirk Horgen,125834,46,2021,503,1,12045,132
106,Bezirk Horgen,125834,47,2021,701,2,12746,134
106,Bezirk Horgen,125834,48,2021,696,2,13442,136
106,Bezirk Horgen,125834,49,2021,810,1,14252,137
106,Bezirk Horgen,125834,50,2021,709,2,14961,139
106,Bezirk Horgen,125834,51,2021,775,1,15736,140
106,Bezirk Horgen,125834,52,2021,1163,4,16899,144
106,Bezirk Horgen,125834,1,2022,2172,0,19071,144
106,Bezirk Horgen,125834,2,2022,2923,0,21994,144
106,Bezirk Horgen,125834,3,2022,3574,2,25568,146
106,Bezirk Horgen,125834,4,2022,3570,0,29138,146
106,Bezirk Horgen,125834,5,2022,2876,2,32014,148
106,Bezirk Horgen,125834,6,2022,2143,0,34157,148
106,Bezirk Horgen,125834,7,2022,1501,1,35658,149
106,Bezirk Horgen,125834,8,2022,1205,1,36863,150
106,Bezirk Horgen,125834,9,2022,1840,1,38703,151
106,Bezirk Horgen,125834,10,2022,2899,0,41602,151
106,Bezirk Horgen,125834,11,2022,3275,2,44877,153
106,Bezirk Horgen,125834,12,2022,2736,2,47613,155
106,Bezirk Horgen,125834,13,2022,1320,1,48933,156
106,Bezirk Horgen,125834,14,2022,693,0,49626,156
106,Bezirk Horgen,125834,15,2022,607,0,50233,156
106,Bezirk Horgen,125834,16,2022,432,0,50665,156
106,Bezirk Horgen,125834,17,2022,320,0,50985,156
106,Bezirk Horgen,125834,18,2022,259,0,51244,156
106,Bezirk Horgen,125834,19,2022,222,0,51466,156
106,Bezirk Horgen,125834,20,2022,120,0,51586,156
106,Bezirk Horgen,125834,21,2022,132,0,51718,156
106,Bezirk Horgen,125834,22,2022,180,0,51898,156
106,Bezirk Horgen,125834,23,2022,292,0,52190,156
106,Bezirk Horgen,125834,24,2022,420,0,52610,156
106,Bezirk Horgen,125834,25,2022,586,0,53196,156
106,Bezirk Horgen,125834,26,2022,830,0,54026,156
106,Bezirk Horgen,125834,27,2022,1122,0,55148,156
106,Bezirk Horgen,125834,28,2022,1094,0,56242,156
106,Bezirk Horgen,125834,29,2022,715,0,56957,156
106,Bezirk Horgen,125834,30,2022,444,1,57401,157
106,Bezirk Horgen,125834,31,2022,291,0,57692,157
106,Bezirk Horgen,125834,32,2022,265,0,57957,157
106,Bezirk Horgen,125834,33,2022,283,0,58240,157
106,Bezirk Horgen,125834,34,2022,262,1,58502,158
106,Bezirk Horgen,125834,35,2022,263,0,58765,158
106,Bezirk Horgen,125834,36,2022,242,0,59007,158
106,Bezirk Horgen,125834,37,2022,214,0,59221,158
106,Bezirk Horgen,125834,38,2022,291,0,59512,158
106,Bezirk Horgen,125834,39,2022,458,0,59970,158
106,Bezirk Horgen,125834,40,2022,684,0,60654,158
106,Bezirk Horgen,125834,41,2022,604,1,61258,159
106,Bezirk Horgen,125834,42,2022,468,0,61726,159
106,Bezirk Horgen,125834,43,2022,430,0,62156,159
106,Bezirk Horgen,125834,44,2022,425,0,62581,159
106,Bezirk Horgen,125834,45,2022,339,0,62920,159
106,Bezirk Horgen,125834,46,2022,370,0,63290,159
106,Bezirk Horgen,125834,47,2022,285,0,63575,159
106,Bezirk Horgen,125834,48,2022,277,0,63852,159
106,Bezirk Horgen,125834,49,2022,251,1,64103,160
106,Bezirk Horgen,125834,50,2022,224,0,64327,160
106,Bezirk Horgen,125834,51,2022,206,1,64533,161
106,Bezirk Horgen,125834,52,2022,98,0,64631,161
107,Bezirk Meilen,104274,9,2020,0,0,0,0
107,Bezirk Meilen,104274,10,2020,4,0,4,0
107,Bezirk Meilen,104274,11,2020,12,0,16,0
107,Bezirk Meilen,104274,12,2020,67,0,83,0
107,Bezirk Meilen,104274,13,2020,54,2,137,2
107,Bezirk Meilen,104274,14,2020,35,2,172,4
107,Bezirk Meilen,104274,15,2020,32,1,204,5
107,Bezirk Meilen,104274,16,2020,7,0,211,5
107,Bezirk Meilen,104274,17,2020,3,0,214,5
107,Bezirk Meilen,104274,18,2020,6,0,220,5
107,Bezirk Meilen,104274,19,2020,2,0,222,5
107,Bezirk Meilen,104274,20,2020,1,0,223,5
107,Bezirk Meilen,104274,21,2020,0,0,223,5
107,Bezirk Meilen,104274,22,2020,1,0,224,5
107,Bezirk Meilen,104274,23,2020,1,0,225,5
107,Bezirk Meilen,104274,24,2020,0,0,225,5
107,Bezirk Meilen,104274,25,2020,2,0,227,5
107,Bezirk Meilen,104274,26,2020,1,0,228,5
107,Bezirk Meilen,104274,27,2020,14,0,242,5
107,Bezirk Meilen,104274,28,2020,13,2,255,7
107,Bezirk Meilen,104274,29,2020,9,0,264,7
107,Bezirk Meilen,104274,30,2020,11,1,275,8
107,Bezirk Meilen,104274,31,2020,5,0,280,8
107,Bezirk Meilen,104274,32,2020,13,0,293,8
107,Bezirk Meilen,104274,33,2020,24,0,317,8
107,Bezirk Meilen,104274,34,2020,27,0,344,8
107,Bezirk Meilen,104274,35,2020,40,0,384,8
107,Bezirk Meilen,104274,36,2020,42,0,426,8
107,Bezirk Meilen,104274,37,2020,38,0,464,8
107,Bezirk Meilen,104274,38,2020,19,0,483,8
107,Bezirk Meilen,104274,39,2020,23,0,506,8
107,Bezirk Meilen,104274,40,2020,41,0,547,8
107,Bezirk Meilen,104274,41,2020,69,0,616,8
107,Bezirk Meilen,104274,42,2020,157,0,773,8
107,Bezirk Meilen,104274,43,2020,335,0,1108,8
107,Bezirk Meilen,104274,44,2020,425,0,1533,8
107,Bezirk Meilen,104274,45,2020,351,1,1884,9
107,Bezirk Meilen,104274,46,2020,216,2,2100,11
107,Bezirk Meilen,104274,47,2020,206,4,2306,15
107,Bezirk Meilen,104274,48,2020,235,1,2541,16
107,Bezirk Meilen,104274,49,2020,272,2,2813,18
107,Bezirk Meilen,104274,50,2020,300,3,3113,21
107,Bezirk Meilen,104274,51,2020,285,6,3398,27
107,Bezirk Meilen,104274,52,2020,348,7,3746,34
107,Bezirk Meilen,104274,53,2020,327,4,4073,38
107,Bezirk Meilen,104274,1,2021,321,5,4394,43
107,Bezirk Meilen,104274,2,2021,237,3,4631,46
107,Bezirk Meilen,104274,3,2021,176,7,4807,53
107,Bezirk Meilen,104274,4,2021,133,7,4940,60
107,Bezirk Meilen,104274,5,2021,133,6,5073,66
107,Bezirk Meilen,104274,6,2021,96,3,5169,69
107,Bezirk Meilen,104274,7,2021,64,2,5233,71
107,Bezirk Meilen,104274,8,2021,46,1,5279,72
107,Bezirk Meilen,104274,9,2021,77,1,5356,73
107,Bezirk Meilen,104274,10,2021,93,0,5449,73
107,Bezirk Meilen,104274,11,2021,88,2,5537,75
107,Bezirk Meilen,104274,12,2021,146,2,5683,77
107,Bezirk Meilen,104274,13,2021,121,3,5804,80
107,Bezirk Meilen,104274,14,2021,159,1,5963,81
107,Bezirk Meilen,104274,15,2021,170,0,6133,81
107,Bezirk Meilen,104274,16,2021,181,1,6314,82
107,Bezirk Meilen,104274,17,2021,144,0,6458,82
107,Bezirk Meilen,104274,18,2021,87,0,6545,82
107,Bezirk Meilen,104274,19,2021,65,0,6610,82
107,Bezirk Meilen,104274,20,2021,71,1,6681,83
107,Bezirk Meilen,104274,21,2021,36,1,6717,84
107,Bezirk Meilen,104274,22,2021,26,1,6743,85
107,Bezirk Meilen,104274,23,2021,22,0,6765,85
107,Bezirk Meilen,104274,24,2021,6,0,6771,85
107,Bezirk Meilen,104274,25,2021,3,0,6774,85
107,Bezirk Meilen,104274,26,2021,11,0,6785,85
107,Bezirk Meilen,104274,27,2021,47,0,6832,85
107,Bezirk Meilen,104274,28,2021,70,0,6902,85
107,Bezirk Meilen,104274,29,2021,62,0,6964,85
107,Bezirk Meilen,104274,30,2021,54,0,7018,85
107,Bezirk Meilen,104274,31,2021,68,0,7086,85
107,Bezirk Meilen,104274,32,2021,71,0,7157,85
107,Bezirk Meilen,104274,33,2021,129,0,7286,85
107,Bezirk Meilen,104274,34,2021,158,0,7444,85
107,Bezirk Meilen,104274,35,2021,212,0,7656,85
107,Bezirk Meilen,104274,36,2021,155,0,7811,85
107,Bezirk Meilen,104274,37,2021,93,0,7904,85
107,Bezirk Meilen,104274,38,2021,80,0,7984,85
107,Bezirk Meilen,104274,39,2021,62,0,8046,85
107,Bezirk Meilen,104274,40,2021,57,1,8103,86
107,Bezirk Meilen,104274,41,2021,63,1,8166,87
107,Bezirk Meilen,104274,42,2021,54,1,8220,88
107,Bezirk Meilen,104274,43,2021,93,1,8313,89
107,Bezirk Meilen,104274,44,2021,143,0,8456,89
107,Bezirk Meilen,104274,45,2021,195,1,8651,90
107,Bezirk Meilen,104274,46,2021,320,2,8971,92
107,Bezirk Meilen,104274,47,2021,584,0,9555,92
107,Bezirk Meilen,104274,48,2021,620,2,10175,94
107,Bezirk Meilen,104274,49,2021,807,1,10982,95
107,Bezirk Meilen,104274,50,2021,693,2,11675,97
107,Bezirk Meilen,104274,51,2021,814,2,12489,99
107,Bezirk Meilen,104274,52,2021,1018,3,13507,102
107,Bezirk Meilen,104274,1,2022,2051,2,15558,104
107,Bezirk Meilen,104274,2,2022,2139,2,17697,106
107,Bezirk Meilen,104274,3,2022,2375,0,20072,106
107,Bezirk Meilen,104274,4,2022,2163,1,22235,107
107,Bezirk Meilen,104274,5,2022,2022,3,24257,110
107,Bezirk Meilen,104274,6,2022,1616,2,25873,112
107,Bezirk Meilen,104274,7,2022,1138,0,27011,112
107,Bezirk Meilen,104274,8,2022,992,0,28003,112
107,Bezirk Meilen,104274,9,2022,1635,0,29638,112
107,Bezirk Meilen,104274,10,2022,2432,2,32070,114
107,Bezirk Meilen,104274,11,2022,2987,0,35057,114
107,Bezirk Meilen,104274,12,2022,2481,3,37538,117
107,Bezirk Meilen,104274,13,2022,1130,0,38668,117
107,Bezirk Meilen,104274,14,2022,657,1,39325,118
107,Bezirk Meilen,104274,15,2022,494,0,39819,118
107,Bezirk Meilen,104274,16,2022,404,0,40223,118
107,Bezirk Meilen,104274,17,2022,347,0,40570,118
107,Bezirk Meilen,104274,18,2022,230,0,40800,118
107,Bezirk Meilen,104274,19,2022,207,1,41007,119
107,Bezirk Meilen,104274,20,2022,148,0,41155,119
107,Bezirk Meilen,104274,21,2022,125,1,41280,120
107,Bezirk Meilen,104274,22,2022,202,0,41482,120
107,Bezirk Meilen,104274,23,2022,299,0,41781,120
107,Bezirk Meilen,104274,24,2022,397,0,42178,120
107,Bezirk Meilen,104274,25,2022,579,0,42757,120
107,Bezirk Meilen,104274,26,2022,692,0,43449,120
107,Bezirk Meilen,104274,27,2022,873,0,44322,120
107,Bezirk Meilen,104274,28,2022,790,1,45112,121
107,Bezirk Meilen,104274,29,2022,576,0,45688,121
107,Bezirk Meilen,104274,30,2022,340,1,46028,122
107,Bezirk Meilen,104274,31,2022,247,0,46275,122
107,Bezirk Meilen,104274,32,2022,240,0,46515,122
107,Bezirk Meilen,104274,33,2022,220,0,46735,122
107,Bezirk Meilen,104274,34,2022,218,0,46953,122
107,Bezirk Meilen,104274,35,2022,247,2,47200,124
107,Bezirk Meilen,104274,36,2022,257,0,47457,124
107,Bezirk Meilen,104274,37,2022,212,2,47669,126
107,Bezirk Meilen,104274,38,2022,267,0,47936,126
107,Bezirk Meilen,104274,39,2022,410,0,48346,126
107,Bezirk Meilen,104274,40,2022,577,0,48923,126
107,Bezirk Meilen,104274,41,2022,536,0,49459,126
107,Bezirk Meilen,104274,42,2022,415,1,49874,127
107,Bezirk Meilen,104274,43,2022,362,0,50236,127
107,Bezirk Meilen,104274,44,2022,259,2,50495,129
107,Bezirk Meilen,104274,45,2022,277,0,50772,129
107,Bezirk Meilen,104274,46,2022,324,0,51096,129
107,Bezirk Meilen,104274,47,2022,262,0,51358,129
107,Bezirk Meilen,104274,48,2022,256,0,51614,129
107,Bezirk Meilen,104274,49,2022,205,0,51819,129
107,Bezirk Meilen,104274,50,2022,181,0,52000,129
107,Bezirk Meilen,104274,51,2022,145,0,52145,129
107,Bezirk Meilen,104274,52,2022,67,0,52212,129
108,Bezirk Pfäffikon,60703,9,2020,0,0,0,0
108,Bezirk Pfäffikon,60703,10,2020,1,0,1,0
108,Bezirk Pfäffikon,60703,11,2020,7,0,8,0
108,Bezirk Pfäffikon,60703,12,2020,11,0,19,0
108,Bezirk Pfäffikon,60703,13,2020,23,0,42,0
108,Bezirk Pfäffikon,60703,14,2020,28,3,70,3
108,Bezirk Pfäffikon,60703,15,2020,26,0,96,3
108,Bezirk Pfäffikon,60703,16,2020,14,3,110,6
108,Bezirk Pfäffikon,60703,17,2020,3,1,113,7
108,Bezirk Pfäffikon,60703,18,2020,2,0,115,7
108,Bezirk Pfäffikon,60703,19,2020,0,0,115,7
108,Bezirk Pfäffikon,60703,20,2020,1,0,116,7
108,Bezirk Pfäffikon,60703,21,2020,0,0,116,7
108,Bezirk Pfäffikon,60703,22,2020,1,0,117,7
108,Bezirk Pfäffikon,60703,23,2020,0,0,117,7
108,Bezirk Pfäffikon,60703,24,2020,1,0,118,7
108,Bezirk Pfäffikon,60703,25,2020,1,0,119,7
108,Bezirk Pfäffikon,60703,26,2020,2,0,121,7
108,Bezirk Pfäffikon,60703,27,2020,9,0,130,7
108,Bezirk Pfäffikon,60703,28,2020,2,0,132,7
108,Bezirk Pfäffikon,60703,29,2020,5,0,137,7
108,Bezirk Pfäffikon,60703,30,2020,7,0,144,7
108,Bezirk Pfäffikon,60703,31,2020,17,0,161,7
108,Bezirk Pfäffikon,60703,32,2020,4,1,165,8
108,Bezirk Pfäffikon,60703,33,2020,8,0,173,8
108,Bezirk Pfäffikon,60703,34,2020,4,0,177,8
108,Bezirk Pfäffikon,60703,35,2020,8,0,185,8
108,Bezirk Pfäffikon,60703,36,2020,16,0,201,8
108,Bezirk Pfäffikon,60703,37,2020,17,0,218,8
108,Bezirk Pfäffikon,60703,38,2020,21,0,239,8
108,Bezirk Pfäffikon,60703,39,2020,10,0,249,8
108,Bezirk Pfäffikon,60703,40,2020,18,0,267,8
108,Bezirk Pfäffikon,60703,41,2020,33,0,300,8
108,Bezirk Pfäffikon,60703,42,2020,76,0,376,8
108,Bezirk Pfäffikon,60703,43,2020,131,0,507,8
108,Bezirk Pfäffikon,60703,44,2020,172,2,679,10
108,Bezirk Pfäffikon,60703,45,2020,245,1,924,11
108,Bezirk Pfäffikon,60703,46,2020,188,2,1112,13
108,Bezirk Pfäffikon,60703,47,2020,169,3,1281,16
108,Bezirk Pfäffikon,60703,48,2020,188,1,1469,17
108,Bezirk Pfäffikon,60703,49,2020,212,0,1681,17
108,Bezirk Pfäffikon,60703,50,2020,204,2,1885,19
108,Bezirk Pfäffikon,60703,51,2020,228,5,2113,24
108,Bezirk Pfäffikon,60703,52,2020,190,2,2303,26
108,Bezirk Pfäffikon,60703,53,2020,174,6,2477,32
108,Bezirk Pfäffikon,60703,1,2021,209,3,2686,35
108,Bezirk Pfäffikon,60703,2,2021,151,1,2837,36
108,Bezirk Pfäffikon,60703,3,2021,146,4,2983,40
108,Bezirk Pfäffikon,60703,4,2021,122,1,3105,41
108,Bezirk Pfäffikon,60703,5,2021,102,3,3207,44
108,Bezirk Pfäffikon,60703,6,2021,93,1,3300,45
108,Bezirk Pfäffikon,60703,7,2021,41,2,3341,47
108,Bezirk Pfäffikon,60703,8,2021,45,0,3386,47
108,Bezirk Pfäffikon,60703,9,2021,42,0,3428,47
108,Bezirk Pfäffikon,60703,10,2021,23,0,3451,47
108,Bezirk Pfäffikon,60703,11,2021,38,1,3489,48
108,Bezirk Pfäffikon,60703,12,2021,122,0,3611,48
108,Bezirk Pfäffikon,60703,13,2021,97,0,3708,48
108,Bezirk Pfäffikon,60703,14,2021,82,1,3790,49
108,Bezirk Pfäffikon,60703,15,2021,93,0,3883,49
108,Bezirk Pfäffikon,60703,16,2021,111,0,3994,49
108,Bezirk Pfäffikon,60703,17,2021,66,1,4060,50
108,Bezirk Pfäffikon,60703,18,2021,39,0,4099,50
108,Bezirk Pfäffikon,60703,19,2021,45,0,4144,50
108,Bezirk Pfäffikon,60703,20,2021,46,0,4190,50
108,Bezirk Pfäffikon,60703,21,2021,31,0,4221,50
108,Bezirk Pfäffikon,60703,22,2021,29,1,4250,51
108,Bezirk Pfäffikon,60703,23,2021,18,0,4268,51
108,Bezirk Pfäffikon,60703,24,2021,12,2,4280,53
108,Bezirk Pfäffikon,60703,25,2021,4,0,4284,53
108,Bezirk Pfäffikon,60703,26,2021,5,0,4289,53
108,Bezirk Pfäffikon,60703,27,2021,8,0,4297,53
108,Bezirk Pfäffikon,60703,28,2021,21,0,4318,53
108,Bezirk Pfäffikon,60703,29,2021,42,0,4360,53
108,Bezirk Pfäffikon,60703,30,2021,23,0,4383,53
108,Bezirk Pfäffikon,60703,31,2021,40,0,4423,53
108,Bezirk Pfäffikon,60703,32,2021,113,0,4536,53
108,Bezirk Pfäffikon,60703,33,2021,139,1,4675,54
108,Bezirk Pfäffikon,60703,34,2021,131,0,4806,54
108,Bezirk Pfäffikon,60703,35,2021,119,0,4925,54
108,Bezirk Pfäffikon,60703,36,2021,135,1,5060,55
108,Bezirk Pfäffikon,60703,37,2021,112,0,5172,55
108,Bezirk Pfäffikon,60703,38,2021,74,1,5246,56
108,Bezirk Pfäffikon,60703,39,2021,65,0,5311,56
108,Bezirk Pfäffikon,60703,40,2021,51,0,5362,56
108,Bezirk Pfäffikon,60703,41,2021,44,0,5406,56
108,Bezirk Pfäffikon,60703,42,2021,78,1,5484,57
108,Bezirk Pfäffikon,60703,43,2021,98,1,5582,58
108,Bezirk Pfäffikon,60703,44,2021,114,0,5696,58
108,Bezirk Pfäffikon,60703,45,2021,119,1,5815,59
108,Bezirk Pfäffikon,60703,46,2021,231,0,6046,59
108,Bezirk Pfäffikon,60703,47,2021,446,1,6492,60
108,Bezirk Pfäffikon,60703,48,2021,450,0,6942,60
108,Bezirk Pfäffikon,60703,49,2021,570,3,7512,63
108,Bezirk Pfäffikon,60703,50,2021,469,0,7981,63
108,Bezirk Pfäffikon,60703,51,2021,373,1,8354,64
108,Bezirk Pfäffikon,60703,52,2021,573,0,8927,64
108,Bezirk Pfäffikon,60703,1,2022,806,0,9733,64
108,Bezirk Pfäffikon,60703,2,2022,1026,0,10759,64
108,Bezirk Pfäffikon,60703,3,2022,1389,1,12148,65
108,Bezirk Pfäffikon,60703,4,2022,1600,0,13748,65
108,Bezirk Pfäffikon,60703,5,2022,1547,1,15295,66
108,Bezirk Pfäffikon,60703,6,2022,1220,1,16515,67
108,Bezirk Pfäffikon,60703,7,2022,899,0,17414,67
108,Bezirk Pfäffikon,60703,8,2022,693,2,18107,69
108,Bezirk Pfäffikon,60703,9,2022,1058,0,19165,69
108,Bezirk Pfäffikon,60703,10,2022,1523,0,20688,69
108,Bezirk Pfäffikon,60703,11,2022,1651,1,22339,70
108,Bezirk Pfäffikon,60703,12,2022,1340,0,23679,70
108,Bezirk Pfäffikon,60703,13,2022,609,1,24288,71
108,Bezirk Pfäffikon,60703,14,2022,358,0,24646,71
108,Bezirk Pfäffikon,60703,15,2022,294,1,24940,72
108,Bezirk Pfäffikon,60703,16,2022,209,0,25149,72
108,Bezirk Pfäffikon,60703,17,2022,167,0,25316,72
108,Bezirk Pfäffikon,60703,18,2022,125,0,25441,72
108,Bezirk Pfäffikon,60703,19,2022,57,0,25498,72
108,Bezirk Pfäffikon,60703,20,2022,47,0,25545,72
108,Bezirk Pfäffikon,60703,21,2022,42,0,25587,72
108,Bezirk Pfäffikon,60703,22,2022,51,0,25638,72
108,Bezirk Pfäffikon,60703,23,2022,91,0,25729,72
108,Bezirk Pfäffikon,60703,24,2022,160,0,25889,72
108,Bezirk Pfäffikon,60703,25,2022,249,0,26138,72
108,Bezirk Pfäffikon,60703,26,2022,308,2,26446,74
108,Bezirk Pfäffikon,60703,27,2022,426,0,26872,74
108,Bezirk Pfäffikon,60703,28,2022,414,1,27286,75
108,Bezirk Pfäffikon,60703,29,2022,339,0,27625,75
108,Bezirk Pfäffikon,60703,30,2022,224,0,27849,75
108,Bezirk Pfäffikon,60703,31,2022,145,0,27994,75
108,Bezirk Pfäffikon,60703,32,2022,170,2,28164,77
108,Bezirk Pfäffikon,60703,33,2022,141,0,28305,77
108,Bezirk Pfäffikon,60703,34,2022,121,0,28426,77
108,Bezirk Pfäffikon,60703,35,2022,144,0,28570,77
108,Bezirk Pfäffikon,60703,36,2022,102,0,28672,77
108,Bezirk Pfäffikon,60703,37,2022,131,0,28803,77
108,Bezirk Pfäffikon,60703,38,2022,132,0,28935,77
108,Bezirk Pfäffikon,60703,39,2022,181,0,29116,77
108,Bezirk Pfäffikon,60703,40,2022,333,0,29449,77
108,Bezirk Pfäffikon,60703,41,2022,297,0,29746,77
108,Bezirk Pfäffikon,60703,42,2022,306,0,30052,77
108,Bezirk Pfäffikon,60703,43,2022,240,0,30292,77
108,Bezirk Pfäffikon,60703,44,2022,200,1,30492,78
108,Bezirk Pfäffikon,60703,45,2022,144,0,30636,78
108,Bezirk Pfäffikon,60703,46,2022,132,1,30768,79
108,Bezirk Pfäffikon,60703,47,2022,162,0,30930,79
108,Bezirk Pfäffikon,60703,48,2022,157,0,31087,79
108,Bezirk Pfäffikon,60703,49,2022,137,0,31224,79
108,Bezirk Pfäffikon,60703,50,2022,131,0,31355,79
108,Bezirk Pfäffikon,60703,51,2022,75,0,31430,79
108,Bezirk Pfäffikon,60703,52,2022,42,0,31472,79
109,Bezirk Uster,131422,9,2020,0,0,0,0
109,Bezirk Uster,131422,10,2020,1,0,1,0
109,Bezirk Uster,131422,11,2020,13,0,14,0
109,Bezirk Uster,131422,12,2020,56,1,70,1
109,Bezirk Uster,131422,13,2020,44,2,114,3
109,Bezirk Uster,131422,14,2020,57,1,171,4
109,Bezirk Uster,131422,15,2020,39,1,210,5
109,Bezirk Uster,131422,16,2020,13,0,223,5
109,Bezirk Uster,131422,17,2020,10,0,233,5
109,Bezirk Uster,131422,18,2020,3,1,236,6
109,Bezirk Uster,131422,19,2020,2,0,238,6
109,Bezirk Uster,131422,20,2020,1,0,239,6
109,Bezirk Uster,131422,21,2020,1,1,240,7
109,Bezirk Uster,131422,22,2020,0,0,240,7
109,Bezirk Uster,131422,23,2020,2,0,242,7
109,Bezirk Uster,131422,24,2020,1,0,243,7
109,Bezirk Uster,131422,25,2020,4,0,247,7
109,Bezirk Uster,131422,26,2020,6,0,253,7
109,Bezirk Uster,131422,27,2020,30,0,283,7
109,Bezirk Uster,131422,28,2020,7,0,290,7
109,Bezirk Uster,131422,29,2020,13,0,303,7
109,Bezirk Uster,131422,30,2020,13,0,316,7
109,Bezirk Uster,131422,31,2020,19,0,335,7
109,Bezirk Uster,131422,32,2020,16,0,351,7
109,Bezirk Uster,131422,33,2020,26,0,377,7
109,Bezirk Uster,131422,34,2020,29,0,406,7
109,Bezirk Uster,131422,35,2020,28,0,434,7
109,Bezirk Uster,131422,36,2020,41,0,475,7
109,Bezirk Uster,131422,37,2020,29,0,504,7
109,Bezirk Uster,131422,38,2020,24,0,528,7
109,Bezirk Uster,131422,39,2020,27,0,555,7
109,Bezirk Uster,131422,40,2020,50,0,605,7
109,Bezirk Uster,131422,41,2020,85,0,690,7
109,Bezirk Uster,131422,42,2020,197,0,887,7
109,Bezirk Uster,131422,43,2020,326,1,1213,8
109,Bezirk Uster,131422,44,2020,550,1,1763,9
109,Bezirk Uster,131422,45,2020,510,3,2273,12
109,Bezirk Uster,131422,46,2020,397,1,2670,13
109,Bezirk Uster,131422,47,2020,400,2,3070,15
109,Bezirk Uster,131422,48,2020,363,2,3433,17
109,Bezirk Uster,131422,49,2020,423,1,3856,18
109,Bezirk Uster,131422,50,2020,506,7,4362,25
109,Bezirk Uster,131422,51,2020,523,11,4885,36
109,Bezirk Uster,131422,52,2020,546,6,5431,42
109,Bezirk Uster,131422,53,2020,498,9,5929,51
109,Bezirk Uster,131422,1,2021,459,9,6388,60
109,Bezirk Uster,131422,2,2021,292,8,6680,68
109,Bezirk Uster,131422,3,2021,304,10,6984,78
109,Bezirk Uster,131422,4,2021,213,11,7197,89
109,Bezirk Uster,131422,5,2021,144,6,7341,95
109,Bezirk Uster,131422,6,2021,121,5,7462,100
109,Bezirk Uster,131422,7,2021,103,2,7565,102
109,Bezirk Uster,131422,8,2021,97,2,7662,104
109,Bezirk Uster,131422,9,2021,128,2,7790,106
109,Bezirk Uster,131422,10,2021,154,1,7944,107
109,Bezirk Uster,131422,11,2021,177,1,8121,108
109,Bezirk Uster,131422,12,2021,185,1,8306,109
109,Bezirk Uster,131422,13,2021,204,0,8510,109
109,Bezirk Uster,131422,14,2021,225,2,8735,111
109,Bezirk Uster,131422,15,2021,280,2,9015,113
109,Bezirk Uster,131422,16,2021,276,1,9291,114
109,Bezirk Uster,131422,17,2021,168,1,9459,115
109,Bezirk Uster,131422,18,2021,119,2,9578,117
109,Bezirk Uster,131422,19,2021,108,1,9686,118
109,Bezirk Uster,131422,20,2021,60,1,9746,119
109,Bezirk Uster,131422,21,2021,63,1,9809,120
109,Bezirk Uster,131422,22,2021,42,1,9851,121
109,Bezirk Uster,131422,23,2021,43,0,9894,121
109,Bezirk Uster,131422,24,2021,13,0,9907,121
109,Bezirk Uster,131422,25,2021,11,0,9918,121
109,Bezirk Uster,131422,26,2021,7,0,9925,121
109,Bezirk Uster,131422,27,2021,33,0,9958,121
109,Bezirk Uster,131422,28,2021,57,0,10015,121
109,Bezirk Uster,131422,29,2021,94,0,10109,121
109,Bezirk Uster,131422,30,2021,88,0,10197,121
109,Bezirk Uster,131422,31,2021,95,0,10292,121
109,Bezirk Uster,131422,32,2021,191,0,10483,121
109,Bezirk Uster,131422,33,2021,305,0,10788,121
109,Bezirk Uster,131422,34,2021,310,0,11098,121
109,Bezirk Uster,131422,35,2021,306,4,11404,125
109,Bezirk Uster,131422,36,2021,362,2,11766,127
109,Bezirk Uster,131422,37,2021,200,1,11966,128
109,Bezirk Uster,131422,38,2021,146,0,12112,128
109,Bezirk Uster,131422,39,2021,124,0,12236,128
109,Bezirk Uster,131422,40,2021,104,1,12340,129
109,Bezirk Uster,131422,41,2021,64,1,12404,130
109,Bezirk Uster,131422,42,2021,83,0,12487,130
109,Bezirk Uster,131422,43,2021,148,0,12635,130
109,Bezirk Uster,131422,44,2021,209,1,12844,131
109,Bezirk Uster,131422,45,2021,276,0,13120,131
109,Bezirk Uster,131422,46,2021,328,1,13448,132
109,Bezirk Uster,131422,47,2021,574,2,14022,134
109,Bezirk Uster,131422,48,2021,591,1,14613,135
109,Bezirk Uster,131422,49,2021,771,0,15384,135
109,Bezirk Uster,131422,50,2021,891,1,16275,136
109,Bezirk Uster,131422,51,2021,854,1,17129,137
109,Bezirk Uster,131422,52,2021,1282,1,18411,138
109,Bezirk Uster,131422,1,2022,2069,1,20480,139
109,Bezirk Uster,131422,2,2022,2433,2,22913,141
109,Bezirk Uster,131422,3,2022,3139,2,26052,143
109,Bezirk Uster,131422,4,2022,3537,1,29589,144
109,Bezirk Uster,131422,5,2022,3286,0,32875,144
109,Bezirk Uster,131422,6,2022,2604,0,35479,144
109,Bezirk Uster,131422,7,2022,1987,2,37466,146
109,Bezirk Uster,131422,8,2022,1359,2,38825,148
109,Bezirk Uster,131422,9,2022,2045,0,40870,148
109,Bezirk Uster,131422,10,2022,3070,2,43940,150
109,Bezirk Uster,131422,11,2022,3762,1,47702,151
109,Bezirk Uster,131422,12,2022,2993,1,50695,152
109,Bezirk Uster,131422,13,2022,1413,1,52108,153
109,Bezirk Uster,131422,14,2022,858,0,52966,153
109,Bezirk Uster,131422,15,2022,645,0,53611,153
109,Bezirk Uster,131422,16,2022,388,0,53999,153
109,Bezirk Uster,131422,17,2022,331,1,54330,154
109,Bezirk Uster,131422,18,2022,284,0,54614,154
109,Bezirk Uster,131422,19,2022,184,0,54798,154
109,Bezirk Uster,131422,20,2022,169,0,54967,154
109,Bezirk Uster,131422,21,2022,133,0,55100,154
109,Bezirk Uster,131422,22,2022,226,1,55326,155
109,Bezirk Uster,131422,23,2022,302,0,55628,155
109,Bezirk Uster,131422,24,2022,438,0,56066,155
109,Bezirk Uster,131422,25,2022,606,0,56672,155
109,Bezirk Uster,131422,26,2022,871,0,57543,155
109,Bezirk Uster,131422,27,2022,1024,0,58567,155
109,Bezirk Uster,131422,28,2022,1028,0,59595,155
109,Bezirk Uster,131422,29,2022,796,0,60391,155
109,Bezirk Uster,131422,30,2022,476,0,60867,155
109,Bezirk Uster,131422,31,2022,353,1,61220,156
109,Bezirk Uster,131422,32,2022,387,1,61607,157
109,Bezirk Uster,131422,33,2022,312,0,61919,157
109,Bezirk Uster,131422,34,2022,271,0,62190,157
109,Bezirk Uster,131422,35,2022,278,0,62468,157
109,Bezirk Uster,131422,36,2022,270,0,62738,157
109,Bezirk Uster,131422,37,2022,224,0,62962,157
109,Bezirk Uster,131422,38,2022,265,0,63227,157
109,Bezirk Uster,131422,39,2022,432,0,63659,157
109,Bezirk Uster,131422,40,2022,624,1,64283,158
109,Bezirk Uster,131422,41,2022,693,0,64976,158
109,Bezirk Uster,131422,42,2022,548,2,65524,160
109,Bezirk Uster,131422,43,2022,457,1,65981,161
109,Bezirk Uster,131422,44,2022,405,1,66386,162
109,Bezirk Uster,131422,45,2022,363,0,66749,162
109,Bezirk Uster,131422,46,2022,386,0,67135,162
109,Bezirk Uster,131422,47,2022,350,0,67485,162
109,Bezirk Uster,131422,48,2022,291,0,67776,162
109,Bezirk Uster,131422,49,2022,273,0,68049,162
109,Bezirk Uster,131422,50,2022,228,0,68277,162
109,Bezirk Uster,131422,51,2022,204,0,68481,162
109,Bezirk Uster,131422,52,2022,88,0,68569,162
110,Bezirk Winterthur,171101,9,2020,0,0,0,0
110,Bezirk Winterthur,171101,10,2020,3,0,3,0
110,Bezirk Winterthur,171101,11,2020,22,0,25,0
110,Bezirk Winterthur,171101,12,2020,61,0,86,0
110,Bezirk Winterthur,171101,13,2020,59,0,145,0
110,Bezirk Winterthur,171101,14,2020,85,2,230,2
110,Bezirk Winterthur,171101,15,2020,57,2,287,4
110,Bezirk Winterthur,171101,16,2020,50,2,337,6
110,Bezirk Winterthur,171101,17,2020,19,1,356,7
110,Bezirk Winterthur,171101,18,2020,12,0,368,7
110,Bezirk Winterthur,171101,19,2020,8,0,376,7
110,Bezirk Winterthur,171101,20,2020,6,0,382,7
110,Bezirk Winterthur,171101,21,2020,1,0,383,7
110,Bezirk Winterthur,171101,22,2020,4,1,387,8
110,Bezirk Winterthur,171101,23,2020,2,0,389,8
110,Bezirk Winterthur,171101,24,2020,3,0,392,8
110,Bezirk Winterthur,171101,25,2020,5,0,397,8
110,Bezirk Winterthur,171101,26,2020,4,0,401,8
110,Bezirk Winterthur,171101,27,2020,15,0,416,8
110,Bezirk Winterthur,171101,28,2020,24,0,440,8
110,Bezirk Winterthur,171101,29,2020,16,0,456,8
110,Bezirk Winterthur,171101,30,2020,19,0,475,8
110,Bezirk Winterthur,171101,31,2020,25,0,500,8
110,Bezirk Winterthur,171101,32,2020,24,0,524,8
110,Bezirk Winterthur,171101,33,2020,32,0,556,8
110,Bezirk Winterthur,171101,34,2020,44,1,600,9
110,Bezirk Winterthur,171101,35,2020,35,0,635,9
110,Bezirk Winterthur,171101,36,2020,32,1,667,10
110,Bezirk Winterthur,171101,37,2020,75,0,742,10
110,Bezirk Winterthur,171101,38,2020,51,1,793,11
110,Bezirk Winterthur,171101,39,2020,42,1,835,12
110,Bezirk Winterthur,171101,40,2020,56,0,891,12
110,Bezirk Winterthur,171101,41,2020,95,2,986,14
110,Bezirk Winterthur,171101,42,2020,204,0,1190,14
110,Bezirk Winterthur,171101,43,2020,352,0,1542,14
110,Bezirk Winterthur,171101,44,2020,405,1,1947,15
110,Bezirk Winterthur,171101,45,2020,542,2,2489,17
110,Bezirk Winterthur,171101,46,2020,530,5,3019,22
110,Bezirk Winterthur,171101,47,2020,593,8,3612,30
110,Bezirk Winterthur,171101,48,2020,447,16,4059,46
110,Bezirk Winterthur,171101,49,2020,633,4,4692,50
110,Bezirk Winterthur,171101,50,2020,824,9,5516,59
110,Bezirk Winterthur,171101,51,2020,688,15,6204,74
110,Bezirk Winterthur,171101,52,2020,548,20,6752,94
110,Bezirk Winterthur,171101,53,2020,444,5,7196,99
110,Bezirk Winterthur,171101,1,2021,443,7,7639,106
110,Bezirk Winterthur,171101,2,2021,233,3,7872,109
110,Bezirk Winterthur,171101,3,2021,203,0,8075,109
110,Bezirk Winterthur,171101,4,2021,196,0,8271,109
110,Bezirk Winterthur,171101,5,2021,174,2,8445,111
110,Bezirk Winterthur,171101,6,2021,119,1,8564,112
110,Bezirk Winterthur,171101,7,2021,109,0,8673,112
110,Bezirk Winterthur,171101,8,2021,99,0,8772,112
110,Bezirk Winterthur,171101,9,2021,119,0,8891,112
110,Bezirk Winterthur,171101,10,2021,126,0,9017,112
110,Bezirk Winterthur,171101,11,2021,209,0,9226,112
110,Bezirk Winterthur,171101,12,2021,208,0,9434,112
110,Bezirk Winterthur,171101,13,2021,228,0,9662,112
110,Bezirk Winterthur,171101,14,2021,310,3,9972,115
110,Bezirk Winterthur,171101,15,2021,293,1,10265,116
110,Bezirk Winterthur,171101,16,2021,317,0,10582,116
110,Bezirk Winterthur,171101,17,2021,252,1,10834,117
110,Bezirk Winterthur,171101,18,2021,201,0,11035,117
110,Bezirk Winterthur,171101,19,2021,148,0,11183,117
110,Bezirk Winterthur,171101,20,2021,150,0,11333,117
110,Bezirk Winterthur,171101,21,2021,111,0,11444,117
110,Bezirk Winterthur,171101,22,2021,83,0,11527,117
110,Bezirk Winterthur,171101,23,2021,60,1,11587,118
110,Bezirk Winterthur,171101,24,2021,40,0,11627,118
110,Bezirk Winterthur,171101,25,2021,20,0,11647,118
110,Bezirk Winterthur,171101,26,2021,17,0,11664,118
110,Bezirk Winterthur,171101,27,2021,36,0,11700,118
110,Bezirk Winterthur,171101,28,2021,82,0,11782,118
110,Bezirk Winterthur,171101,29,2021,73,0,11855,118
110,Bezirk Winterthur,171101,30,2021,82,0,11937,118
110,Bezirk Winterthur,171101,31,2021,147,1,12084,119
110,Bezirk Winterthur,171101,32,2021,315,1,12399,120
110,Bezirk Winterthur,171101,33,2021,505,0,12904,120
110,Bezirk Winterthur,171101,34,2021,475,0,13379,120
110,Bezirk Winterthur,171101,35,2021,518,1,13897,121
110,Bezirk Winterthur,171101,36,2021,533,3,14430,124
110,Bezirk Winterthur,171101,37,2021,384,1,14814,125
110,Bezirk Winterthur,171101,38,2021,235,3,15049,128
110,Bezirk Winterthur,171101,39,2021,193,0,15242,128
110,Bezirk Winterthur,171101,40,2021,132,1,15374,129
110,Bezirk Winterthur,171101,41,2021,83,0,15457,129
110,Bezirk Winterthur,171101,42,2021,147,0,15604,129
110,Bezirk Winterthur,171101,43,2021,289,0,15893,129
110,Bezirk Winterthur,171101,44,2021,408,1,16301,130
110,Bezirk Winterthur,171101,45,2021,636,3,16937,133
110,Bezirk Winterthur,171101,46,2021,843,1,17780,134
110,Bezirk Winterthur,171101,47,2021,1063,1,18843,135
110,Bezirk Winterthur,171101,48,2021,1136,5,19979,140
110,Bezirk Winterthur,171101,49,2021,1283,1,21262,141
110,Bezirk Winterthur,171101,50,2021,1004,3,22266,144
110,Bezirk Winterthur,171101,51,2021,1057,1,23323,145
110,Bezirk Winterthur,171101,52,2021,1492,0,24815,145
110,Bezirk Winterthur,171101,1,2022,2372,0,27187,145
110,Bezirk Winterthur,171101,2,2022,2772,1,29959,146
110,Bezirk Winterthur,171101,3,2022,3727,0,33686,146
110,Bezirk Winterthur,171101,4,2022,4384,0,38070,146
110,Bezirk Winterthur,171101,5,2022,4426,1,42496,147
110,Bezirk Winterthur,171101,6,2022,2981,3,45477,150
110,Bezirk Winterthur,171101,7,2022,2239,2,47716,152
110,Bezirk Winterthur,171101,8,2022,2194,2,49910,154
110,Bezirk Winterthur,171101,9,2022,3774,2,53684,156
110,Bezirk Winterthur,171101,10,2022,5056,1,58740,157
110,Bezirk Winterthur,171101,11,2022,4791,1,63531,158
110,Bezirk Winterthur,171101,12,2022,3167,2,66698,160
110,Bezirk Winterthur,171101,13,2022,1573,1,68271,161
110,Bezirk Winterthur,171101,14,2022,844,0,69115,161
110,Bezirk Winterthur,171101,15,2022,695,2,69810,163
110,Bezirk Winterthur,171101,16,2022,528,0,70338,163
110,Bezirk Winterthur,171101,17,2022,389,0,70727,163
110,Bezirk Winterthur,171101,18,2022,282,0,71009,163
110,Bezirk Winterthur,171101,19,2022,294,0,71303,163
110,Bezirk Winterthur,171101,20,2022,190,0,71493,163
110,Bezirk Winterthur,171101,21,2022,157,0,71650,163
110,Bezirk Winterthur,171101,22,2022,191,0,71841,163
110,Bezirk Winterthur,171101,23,2022,298,0,72139,163
110,Bezirk Winterthur,171101,24,2022,430,0,72569,163
110,Bezirk Winterthur,171101,25,2022,696,0,73265,163
110,Bezirk Winterthur,171101,26,2022,959,0,74224,163
110,Bezirk Winterthur,171101,27,2022,1422,0,75646,163
110,Bezirk Winterthur,171101,28,2022,1303,0,76949,163
110,Bezirk Winterthur,171101,29,2022,949,0,77898,163
110,Bezirk Winterthur,171101,30,2022,552,0,78450,163
110,Bezirk Winterthur,171101,31,2022,375,2,78825,165
110,Bezirk Winterthur,171101,32,2022,468,0,79293,165
110,Bezirk Winterthur,171101,33,2022,369,0,79662,165
110,Bezirk Winterthur,171101,34,2022,402,0,80064,165
110,Bezirk Winterthur,171101,35,2022,390,0,80454,165
110,Bezirk Winterthur,171101,36,2022,328,0,80782,165
110,Bezirk Winterthur,171101,37,2022,375,0,81157,165
110,Bezirk Winterthur,171101,38,2022,420,1,81577,166
110,Bezirk Winterthur,171101,39,2022,565,0,82142,166
110,Bezirk Winterthur,171101,40,2022,852,1,82994,167
110,Bezirk Winterthur,171101,41,2022,836,0,83830,167
110,Bezirk Winterthur,171101,42,2022,730,1,84560,168
110,Bezirk Winterthur,171101,43,2022,598,0,85158,168
110,Bezirk Winterthur,171101,44,2022,541,1,85699,169
110,Bezirk Winterthur,171101,45,2022,492,0,86191,169
110,Bezirk Winterthur,171101,46,2022,459,0,86650,169
110,Bezirk Winterthur,171101,47,2022,359,0,87009,169
110,Bezirk Winterthur,171101,48,2022,353,0,87362,169
110,Bezirk Winterthur,171101,49,2022,296,0,87658,169
110,Bezirk Winterthur,171101,50,2022,233,1,87891,170
110,Bezirk Winterthur,171101,51,2022,168,0,88059,170
110,Bezirk Winterthur,171101,52,2022,101,0,88160,170
111,Bezirk Dietikon,92275,9,2020,0,0,0,0
111,Bezirk Dietikon,92275,10,2020,2,0,2,0
111,Bezirk Dietikon,92275,11,2020,20,0,22,0
111,Bezirk Dietikon,92275,12,2020,38,0,60,0
111,Bezirk Dietikon,92275,13,2020,32,0,92,0
111,Bezirk Dietikon,92275,14,2020,35,1,127,1
111,Bezirk Dietikon,92275,15,2020,21,3,148,4
111,Bezirk Dietikon,92275,16,2020,26,1,174,5
111,Bezirk Dietikon,92275,17,2020,27,0,201,5
111,Bezirk Dietikon,92275,18,2020,8,0,209,5
111,Bezirk Dietikon,92275,19,2020,6,1,215,6
111,Bezirk Dietikon,92275,20,2020,2,0,217,6
111,Bezirk Dietikon,92275,21,2020,1,0,218,6
111,Bezirk Dietikon,92275,22,2020,2,1,220,7
111,Bezirk Dietikon,92275,23,2020,2,0,222,7
111,Bezirk Dietikon,92275,24,2020,1,0,223,7
111,Bezirk Dietikon,92275,25,2020,5,0,228,7
111,Bezirk Dietikon,92275,26,2020,9,0,237,7
111,Bezirk Dietikon,92275,27,2020,23,0,260,7
111,Bezirk Dietikon,92275,28,2020,7,0,267,7
111,Bezirk Dietikon,92275,29,2020,10,0,277,7
111,Bezirk Dietikon,92275,30,2020,8,0,285,7
111,Bezirk Dietikon,92275,31,2020,7,0,292,7
111,Bezirk Dietikon,92275,32,2020,17,0,309,7
111,Bezirk Dietikon,92275,33,2020,30,0,339,7
111,Bezirk Dietikon,92275,34,2020,49,0,388,7
111,Bezirk Dietikon,92275,35,2020,47,0,435,7
111,Bezirk Dietikon,92275,36,2020,23,0,458,7
111,Bezirk Dietikon,92275,37,2020,28,0,486,7
111,Bezirk Dietikon,92275,38,2020,22,0,508,7
111,Bezirk Dietikon,92275,39,2020,21,0,529,7
111,Bezirk Dietikon,92275,40,2020,70,0,599,7
111,Bezirk Dietikon,92275,41,2020,93,0,692,7
111,Bezirk Dietikon,92275,42,2020,147,1,839,8
111,Bezirk Dietikon,92275,43,2020,356,0,1195,8
111,Bezirk Dietikon,92275,44,2020,487,3,1682,11
111,Bezirk Dietikon,92275,45,2020,436,3,2118,14
111,Bezirk Dietikon,92275,46,2020,382,0,2500,14
111,Bezirk Dietikon,92275,47,2020,340,3,2840,17
111,Bezirk Dietikon,92275,48,2020,324,2,3164,19
111,Bezirk Dietikon,92275,49,2020,318,4,3482,23
111,Bezirk Dietikon,92275,50,2020,479,7,3961,30
111,Bezirk Dietikon,92275,51,2020,418,5,4379,35
111,Bezirk Dietikon,92275,52,2020,353,10,4732,45
111,Bezirk Dietikon,92275,53,2020,315,3,5047,48
111,Bezirk Dietikon,92275,1,2021,254,10,5301,58
111,Bezirk Dietikon,92275,2,2021,185,4,5486,62
111,Bezirk Dietikon,92275,3,2021,140,4,5626,66
111,Bezirk Dietikon,92275,4,2021,121,4,5747,70
111,Bezirk Dietikon,92275,5,2021,116,1,5863,71
111,Bezirk Dietikon,92275,6,2021,86,2,5949,73
111,Bezirk Dietikon,92275,7,2021,81,2,6030,75
111,Bezirk Dietikon,92275,8,2021,82,2,6112,77
111,Bezirk Dietikon,92275,9,2021,86,0,6198,77
111,Bezirk Dietikon,92275,10,2021,102,0,6300,77
111,Bezirk Dietikon,92275,11,2021,141,2,6441,79
111,Bezirk Dietikon,92275,12,2021,185,1,6626,80
111,Bezirk Dietikon,92275,13,2021,156,0,6782,80
111,Bezirk Dietikon,92275,14,2021,173,1,6955,81
111,Bezirk Dietikon,92275,15,2021,219,0,7174,81
111,Bezirk Dietikon,92275,16,2021,191,1,7365,82
111,Bezirk Dietikon,92275,17,2021,133,1,7498,83
111,Bezirk Dietikon,92275,18,2021,90,1,7588,84
111,Bezirk Dietikon,92275,19,2021,71,0,7659,84
111,Bezirk Dietikon,92275,20,2021,61,1,7720,85
111,Bezirk Dietikon,92275,21,2021,44,1,7764,86
111,Bezirk Dietikon,92275,22,2021,35,0,7799,86
111,Bezirk Dietikon,92275,23,2021,16,0,7815,86
111,Bezirk Dietikon,92275,24,2021,9,0,7824,86
111,Bezirk Dietikon,92275,25,2021,4,0,7828,86
111,Bezirk Dietikon,92275,26,2021,11,0,7839,86
111,Bezirk Dietikon,92275,27,2021,36,0,7875,86
111,Bezirk Dietikon,92275,28,2021,63,0,7938,86
111,Bezirk Dietikon,92275,29,2021,67,0,8005,86
111,Bezirk Dietikon,92275,30,2021,63,0,8068,86
111,Bezirk Dietikon,92275,31,2021,89,0,8157,86
111,Bezirk Dietikon,92275,32,2021,202,0,8359,86
111,Bezirk Dietikon,92275,33,2021,266,0,8625,86
111,Bezirk Dietikon,92275,34,2021,331,0,8956,86
111,Bezirk Dietikon,92275,35,2021,271,0,9227,86
111,Bezirk Dietikon,92275,36,2021,324,0,9551,86
111,Bezirk Dietikon,92275,37,2021,204,0,9755,86
111,Bezirk Dietikon,92275,38,2021,123,1,9878,87
111,Bezirk Dietikon,92275,39,2021,82,1,9960,88
111,Bezirk Dietikon,92275,40,2021,59,2,10019,90
111,Bezirk Dietikon,92275,41,2021,35,0,10054,90
111,Bezirk Dietikon,92275,42,2021,69,0,10123,90
111,Bezirk Dietikon,92275,43,2021,114,1,10237,91
111,Bezirk Dietikon,92275,44,2021,141,0,10378,91
111,Bezirk Dietikon,92275,45,2021,193,0,10571,91
111,Bezirk Dietikon,92275,46,2021,233,0,10804,91
111,Bezirk Dietikon,92275,47,2021,416,2,11220,93
111,Bezirk Dietikon,92275,48,2021,568,0,11788,93
111,Bezirk Dietikon,92275,49,2021,536,0,12324,93
111,Bezirk Dietikon,92275,50,2021,478,0,12802,93
111,Bezirk Dietikon,92275,51,2021,546,4,13348,97
111,Bezirk Dietikon,92275,52,2021,799,2,14147,99
111,Bezirk Dietikon,92275,1,2022,1639,0,15786,99
111,Bezirk Dietikon,92275,2,2022,1866,1,17652,100
111,Bezirk Dietikon,92275,3,2022,2210,1,19862,101
111,Bezirk Dietikon,92275,4,2022,2191,1,22053,102
111,Bezirk Dietikon,92275,5,2022,2218,1,24271,103
111,Bezirk Dietikon,92275,6,2022,1731,0,26002,103
111,Bezirk Dietikon,92275,7,2022,1153,0,27155,103
111,Bezirk Dietikon,92275,8,2022,850,0,28005,103
111,Bezirk Dietikon,92275,9,2022,1240,2,29245,105
111,Bezirk Dietikon,92275,10,2022,1923,0,31168,105
111,Bezirk Dietikon,92275,11,2022,2279,0,33447,105
111,Bezirk Dietikon,92275,12,2022,1699,0,35146,105
111,Bezirk Dietikon,92275,13,2022,789,0,35935,105
111,Bezirk Dietikon,92275,14,2022,413,0,36348,105
111,Bezirk Dietikon,92275,15,2022,317,1,36665,106
111,Bezirk Dietikon,92275,16,2022,203,0,36868,106
111,Bezirk Dietikon,92275,17,2022,161,0,37029,106
111,Bezirk Dietikon,92275,18,2022,147,0,37176,106
111,Bezirk Dietikon,92275,19,2022,126,0,37302,106
111,Bezirk Dietikon,92275,20,2022,73,0,37375,106
111,Bezirk Dietikon,92275,21,2022,71,0,37446,106
111,Bezirk Dietikon,92275,22,2022,110,0,37556,106
111,Bezirk Dietikon,92275,23,2022,186,0,37742,106
111,Bezirk Dietikon,92275,24,2022,221,0,37963,106
111,Bezirk Dietikon,92275,25,2022,345,0,38308,106
111,Bezirk Dietikon,92275,26,2022,497,0,38805,106
111,Bezirk Dietikon,92275,27,2022,605,0,39410,106
111,Bezirk Dietikon,92275,28,2022,535,0,39945,106
111,Bezirk Dietikon,92275,29,2022,453,0,40398,106
111,Bezirk Dietikon,92275,30,2022,283,0,40681,106
111,Bezirk Dietikon,92275,31,2022,190,0,40871,106
111,Bezirk Dietikon,92275,32,2022,219,0,41090,106
111,Bezirk Dietikon,92275,33,2022,224,0,41314,106
111,Bezirk Dietikon,92275,34,2022,166,0,41480,106
111,Bezirk Dietikon,92275,35,2022,154,0,41634,106
111,Bezirk Dietikon,92275,36,2022,147,0,41781,106
111,Bezirk Dietikon,92275,37,2022,146,0,41927,106
111,Bezirk Dietikon,92275,38,2022,140,0,42067,106
111,Bezirk Dietikon,92275,39,2022,212,0,42279,106
111,Bezirk Dietikon,92275,40,2022,349,0,42628,106
111,Bezirk Dietikon,92275,41,2022,317,0,42945,106
111,Bezirk Dietikon,92275,42,2022,277,0,43222,106
111,Bezirk Dietikon,92275,43,2022,230,0,43452,106
111,Bezirk Dietikon,92275,44,2022,189,0,43641,106
111,Bezirk Dietikon,92275,45,2022,186,0,43827,106
111,Bezirk Dietikon,92275,46,2022,173,0,44000,106
111,Bezirk Dietikon,92275,47,2022,149,0,44149,106
111,Bezirk Dietikon,92275,48,2022,177,0,44326,106
111,Bezirk Dietikon,92275,49,2022,141,0,44467,106
111,Bezirk Dietikon,92275,50,2022,141,0,44608,106
111,Bezirk Dietikon,92275,51,2022,125,0,44733,106
111,Bezirk Dietikon,92275,52,2022,55,0,44788,106
112,Bezirk Zürich,422870,9,2020,8,0,8,0
112,Bezirk Zürich,422870,10,2020,17,0,25,0
112,Bezirk Zürich,422870,11,2020,75,1,100,1
112,Bezirk Zürich,422870,12,2020,227,3,327,4
112,Bezirk Zürich,422870,13,2020,237,6,564,10
112,Bezirk Zürich,422870,14,2020,206,14,770,24
112,Bezirk Zürich,422870,15,2020,177,13,947,37
112,Bezirk Zürich,422870,16,2020,61,15,1008,52
112,Bezirk Zürich,422870,17,2020,58,7,1066,59
112,Bezirk Zürich,422870,18,2020,39,6,1105,65
112,Bezirk Zürich,422870,19,2020,26,2,1131,67
112,Bezirk Zürich,422870,20,2020,10,1,1141,68
112,Bezirk Zürich,422870,21,2020,5,0,1146,68
112,Bezirk Zürich,422870,22,2020,11,0,1157,68
112,Bezirk Zürich,422870,23,2020,10,0,1167,68
112,Bezirk Zürich,422870,24,2020,6,0,1173,68
112,Bezirk Zürich,422870,25,2020,9,0,1182,68
112,Bezirk Zürich,422870,26,2020,24,0,1206,68
112,Bezirk Zürich,422870,27,2020,37,1,1243,69
112,Bezirk Zürich,422870,28,2020,30,0,1273,69
112,Bezirk Zürich,422870,29,2020,40,0,1313,69
112,Bezirk Zürich,422870,30,2020,20,0,1333,69
112,Bezirk Zürich,422870,31,2020,47,1,1380,70
112,Bezirk Zürich,422870,32,2020,50,1,1430,71
112,Bezirk Zürich,422870,33,2020,124,1,1554,72
112,Bezirk Zürich,422870,34,2020,150,0,1704,72
112,Bezirk Zürich,422870,35,2020,186,1,1890,73
112,Bezirk Zürich,422870,36,2020,201,0,2091,73
112,Bezirk Zürich,422870,37,2020,179,0,2270,73
112,Bezirk Zürich,422870,38,2020,124,0,2394,73
112,Bezirk Zürich,422870,39,2020,155,0,2549,73
112,Bezirk Zürich,422870,40,2020,330,1,2879,74
112,Bezirk Zürich,422870,41,2020,524,0,3403,74
112,Bezirk Zürich,422870,42,2020,1054,2,4457,76
112,Bezirk Zürich,422870,43,2020,1725,2,6182,78
112,Bezirk Zürich,422870,44,2020,2295,10,8477,88
112,Bezirk Zürich,422870,45,2020,1888,5,10365,93
112,Bezirk Zürich,422870,46,2020,1498,10,11863,103
112,Bezirk Zürich,422870,47,2020,1239,14,13102,117
112,Bezirk Zürich,422870,48,2020,1225,14,14327,131
112,Bezirk Zürich,422870,49,2020,1373,25,15700,156
112,Bezirk Zürich,422870,50,2020,1489,35,17189,191
112,Bezirk Zürich,422870,51,2020,1494,32,18683,223
112,Bezirk Zürich,422870,52,2020,1347,36,20030,259
112,Bezirk Zürich,422870,53,2020,1297,42,21327,301
112,Bezirk Zürich,422870,1,2021,1113,33,22440,334
112,Bezirk Zürich,422870,2,2021,692,21,23132,355
112,Bezirk Zürich,422870,3,2021,560,27,23692,382
112,Bezirk Zürich,422870,4,2021,486,14,24178,396
112,Bezirk Zürich,422870,5,2021,385,5,24563,401
112,Bezirk Zürich,422870,6,2021,327,4,24890,405
112,Bezirk Zürich,422870,7,2021,339,6,25229,411
112,Bezirk Zürich,422870,8,2021,261,4,25490,415
112,Bezirk Zürich,422870,9,2021,266,1,25756,416
112,Bezirk Zürich,422870,10,2021,340,2,26096,418
112,Bezirk Zürich,422870,11,2021,495,7,26591,425
112,Bezirk Zürich,422870,12,2021,578,3,27169,428
112,Bezirk Zürich,422870,13,2021,607,5,27776,433
112,Bezirk Zürich,422870,14,2021,719,1,28495,434
112,Bezirk Zürich,422870,15,2021,725,2,29220,436
112,Bezirk Zürich,422870,16,2021,689,3,29909,439
112,Bezirk Zürich,422870,17,2021,534,3,30443,442
112,Bezirk Zürich,422870,18,2021,374,2,30817,444
112,Bezirk Zürich,422870,19,2021,291,3,31108,447
112,Bezirk Zürich,422870,20,2021,276,3,31384,450
112,Bezirk Zürich,422870,21,2021,175,0,31559,450
112,Bezirk Zürich,422870,22,2021,132,0,31691,450
112,Bezirk Zürich,422870,23,2021,87,0,31778,450
112,Bezirk Zürich,422870,24,2021,50,1,31828,451
112,Bezirk Zürich,422870,25,2021,25,1,31853,452
112,Bezirk Zürich,422870,26,2021,47,0,31900,452
112,Bezirk Zürich,422870,27,2021,121,0,32021,452
112,Bezirk Zürich,422870,28,2021,312,1,32333,453
112,Bezirk Zürich,422870,29,2021,352,0,32685,453
112,Bezirk Zürich,422870,30,2021,270,0,32955,453
112,Bezirk Zürich,422870,31,2021,272,1,33227,454
112,Bezirk Zürich,422870,32,2021,497,1,33724,455
112,Bezirk Zürich,422870,33,2021,651,1,34375,456
112,Bezirk Zürich,422870,34,2021,759,3,35134,459
112,Bezirk Zürich,422870,35,2021,773,3,35907,462
112,Bezirk Zürich,422870,36,2021,974,2,36881,464
112,Bezirk Zürich,422870,37,2021,636,2,37517,466
112,Bezirk Zürich,422870,38,2021,431,2,37948,468
112,Bezirk Zürich,422870,39,2021,414,4,38362,472
112,Bezirk Zürich,422870,40,2021,320,0,38682,472
112,Bezirk Zürich,422870,41,2021,241,2,38923,474
112,Bezirk Zürich,422870,42,2021,308,0,39231,474
112,Bezirk Zürich,422870,43,2021,421,0,39652,474
112,Bezirk Zürich,422870,44,2021,581,1,40233,475
112,Bezirk Zürich,422870,45,2021,881,3,41114,478
112,Bezirk Zürich,422870,46,2021,1421,1,42535,479
112,Bezirk Zürich,422870,47,2021,2112,4,44647,483
112,Bezirk Zürich,422870,48,2021,2340,4,46987,487
112,Bezirk Zürich,422870,49,2021,2756,5,49743,492
112,Bezirk Zürich,422870,50,2021,2704,5,52447,497
112,Bezirk Zürich,422870,51,2021,3613,0,56060,497
112,Bezirk Zürich,422870,52,2021,4505,4,60565,501
112,Bezirk Zürich,422870,1,2022,8290,8,68855,509
112,Bezirk Zürich,422870,2,2022,9126,1,77981,510
112,Bezirk Zürich,422870,3,2022,11164,4,89145,514
112,Bezirk Zürich,422870,4,2022,11271,1,100416,515
112,Bezirk Zürich,422870,5,2022,9122,4,109538,519
112,Bezirk Zürich,422870,6,2022,6729,4,116267,523
112,Bezirk Zürich,422870,7,2022,5024,4,121291,527
112,Bezirk Zürich,422870,8,2022,4261,1,125552,528
112,Bezirk Zürich,422870,9,2022,6936,4,132488,532
112,Bezirk Zürich,422870,10,2022,9782,4,142270,536
112,Bezirk Zürich,422870,11,2022,11275,2,153545,538
112,Bezirk Zürich,422870,12,2022,8665,5,162210,543
112,Bezirk Zürich,422870,13,2022,4442,3,166652,546
112,Bezirk Zürich,422870,14,2022,2667,3,169319,549
112,Bezirk Zürich,422870,15,2022,2278,4,171597,553
112,Bezirk Zürich,422870,16,2022,1523,3,173120,556
112,Bezirk Zürich,422870,17,2022,1222,3,174342,559
112,Bezirk Zürich,422870,18,2022,991,2,175333,561
112,Bezirk Zürich,422870,19,2022,800,2,176133,563
112,Bezirk Zürich,422870,20,2022,604,0,176737,563
112,Bezirk Zürich,422870,21,2022,498,0,177235,563
112,Bezirk Zürich,422870,22,2022,826,0,178061,563
112,Bezirk Zürich,422870,23,2022,1177,0,179238,563
112,Bezirk Zürich,422870,24,2022,1822,0,181060,563
112,Bezirk Zürich,422870,25,2022,2335,0,183395,563
112,Bezirk Zürich,422870,26,2022,3143,3,186538,566
112,Bezirk Zürich,422870,27,2022,3969,0,190507,566
112,Bezirk Zürich,422870,28,2022,3637,0,194144,566
112,Bezirk Zürich,422870,29,2022,2694,5,196838,571
112,Bezirk Zürich,422870,30,2022,1630,5,198468,576
112,Bezirk Zürich,422870,31,2022,1159,1,199627,577
112,Bezirk Zürich,422870,32,2022,1218,1,200845,578
112,Bezirk Zürich,422870,33,2022,992,1,201837,579
112,Bezirk Zürich,422870,34,2022,914,1,202751,580
112,Bezirk Zürich,422870,35,2022,912,0,203663,580
112,Bezirk Zürich,422870,36,2022,750,0,204413,580
112,Bezirk Zürich,422870,37,2022,704,0,205117,580
112,Bezirk Zürich,422870,38,2022,848,1,205965,581
112,Bezirk Zürich,422870,39,2022,1375,0,207340,581
112,Bezirk Zürich,422870,40,2022,2078,1,209418,582
112,Bezirk Zürich,422870,41,2022,1826,1,211244,583
112,Bezirk Zürich,422870,42,2022,1527,0,212771,583
112,Bezirk Zürich,422870,43,2022,1307,0,214078,583
112,Bezirk Zürich,422870,44,2022,1241,0,215319,583
112,Bezirk Zürich,422870,45,2022,1165,0,216484,583
112,Bezirk Zürich,422870,46,2022,1185,1,217669,584
112,Bezirk Zürich,422870,47,2022,996,2,218665,586
112,Bezirk Zürich,422870,48,2022,1005,1,219670,587
112,Bezirk Zürich,422870,49,2022,944,0,220614,587
112,Bezirk Zürich,422870,50,2022,769,0,221383,587
112,Bezirk Zürich,422870,51,2022,739,4,222122,591
112,Bezirk Zürich,422870,52,2022,370,0,222492,591
